Plot,maxaug_c,mindec_c,continen,precip_cm,N
823,24,-1,25,161,2.09
826,25,1,24,343,3.16
827,24,-6,30,99,2.56
829,24,-7,31,109,2
831,22,-6,28,125,1.92
834,22,-6,28,131,2.39
835,22,-6,28,131,2.39
837,24,-7,31,129,2.39
840,25,-6,31,110,1.99
842,24,-6,30,109,1.93
844,26,-8,34,51,1.54
849,23,-6,29,140,2.08
851,26,-7,33,82,2.09
853,24,-6,30,74,1.97
855,23,-6,29,82,1.97
856,22,-6,28,150,2.45
858,22,-6,28,145,2.14
860,24,-6,30,111,1.5
862,25,-6,31,71,1.97
864,26,-8,34,68,1.94
866,24,-6,30,65,1.97
870,23,-6,29,141,1.82
872,26,-7,33,95,1.71
874,27,-7,34,57,1.56
876,27,-8,35,53,1.57
877,28,-8,36,48,1.46
881,22,-8,30,75,2.28
882,24,2,22,267,2.3
884,25,-7,32,104,1.61
886,26,-7,33,54,1.55
887,27,-8,35,50,1.46
891,27,-8,35,56,1.57
893,27,-8,35,51,1.32
895,25,3,22,252,2.3
896,22,-6,28,167,1.82
898,27,-7,34,52,1.74
902,26,-8,34,60,1.54
904,27,-8,35,53,1.48
905,26,-8,34,64,1.67
907,28,-8,36,52,1.56
908,26,3,23,391,3.69
910,23,-6,29,162,1.85
912,24,-6,30,132,2.21
914,27,-8,35,61,1.62
915,27,-8,35,57,1.57
916,26,-8,34,63,1.57
917,27,-8,35,56,1.57
919,26,-7,33,64,1.58
921,27,-8,35,57,1.56
923,27,-8,35,57,1.56
925,27,-8,35,56,1.52
927,23,4,19,399,3.6
929,25,-1,26,129,2.79
930,25,-1,26,124,2.85
932,26,-1,27,106,2.85
933,23,-6,29,159,2.03
934,26,-7,33,87,2.03
936,26,-8,34,75,1.66
937,26,-8,34,70,1.47
938,27,-8,35,53,1.57
939,27,-8,35,56,1.68
940,27,-8,35,58,1.68
942,28,-8,36,52,1.58
943,26,-8,34,62,1.6
946,27,-8,35,57,1.61
947,28,-1,29,114,2.85
948,28,-1,29,120,2.55
950,24,-3,27,147,2.63
951,25,-7,32,102,1.74
953,25,-6,31,111,1.56
954,26,-8,34,92,1.75
955,27,-8,35,67,1.47
956,27,-8,35,57,1.47
957,27,-8,35,57,1.6
959,27,-8,35,57,1.52
961,28,-8,36,52,1.58
963,28,-1,29,116,2.62
965,25,-1,26,140,2.55
967,25,-7,32,100,1.49
969,26,-9,35,83,1.5
970,27,-8,35,65,1.47
971,27,-8,35,63,1.6
972,27,-8,35,57,1.6
973,27,-8,35,53,1.6
975,27,-1,28,112,2.34
977,25,-2,27,147,2.24
979,24,-2,26,154,2.24
981,24,-7,31,104,1.49
983,27,-8,35,60,1.46
984,27,-9,36,54,1.6
985,30,-2,32,103,2.24
986,25,-2,27,149,2.35
987,22,-5,27,157,2.35
990,23,-6,29,100,1.39
991,26,-9,35,82,1.44
993,28,-9,37,57,1.44
994,27,-9,36,56,1.54
996,30,-1,31,105,2.42
997,29,-1,30,106,2.3
998,29,-2,31,114,2.35
999,25,-8,33,90,1.44
1001,28,-8,36,55,1.54
1002,26,-8,34,76,1.54
1003,22,-6,28,97,2.02
1005,29,-1,30,134,2.42
1007,30,-1,31,107,2.3
1008,30,-2,32,104,2.3
1011,29,-2,31,118,2.16
1013,29,-2,31,118,2.16
1014,25,-9,34,85,1.53
1016,27,-8,35,62,1.55
1017,28,-9,37,59,1.63
1019,26,-8,34,75,1.46
1020,26,-8,34,75,2.02
1021,27,0,27,152,2.94
1024,30,-1,31,110,2.4
1025,28,-1,29,115,2.3
1027,29,-2,31,108,2.16
1028,28,-2,30,118,2.93
1030,24,-5,29,160,2.21
1032,23,-7,30,139,1.83
1033,22,-7,29,125,1.83
1035,24,-7,31,98,1.59
1037,26,-8,34,74,1.57
1039,26,-8,34,73,1.53
1040,26,-8,34,70,1.63
1041,27,-8,35,67,1.63
1042,28,0,28,157,2.94
1044,25,-1,26,149,2.4
1048,27,-1,28,138,2.31
1049,25,-3,28,141,2.19
1051,28,-2,30,129,2.19
1053,25,-3,28,155,2.22
1054,24,-5,29,161,2.22
1055,25,-4,29,149,1.94
1057,22,-7,29,161,2.3
1059,22,-8,30,123,1.97
1060,24,-7,31,102,1.53
1061,23,-7,30,95,1.72
1062,26,-8,34,75,1.72
1063,26,-8,34,72,1.72
1065,28,-1,29,137,2.82
1066,27,-1,28,132,2.4
1067,24,-3,27,170,2.19
1068,23,-2,25,170,2.19
1069,24,-4,28,158,1.96
1070,25,-4,29,148,1.96
1072,25,-4,29,143,2.14
1073,22,-7,29,159,1.94
1074,20,-8,28,148,1.83
1076,24,-6,30,126,1.8
1078,22,-7,29,142,1.85
1079,19,-9,28,154,1.95
1081,23,-7,30,111,1.58
1083,25,-9,34,87,1.58
1085,26,-8,34,75,1.72
1087,25,-8,33,74,1.56
1088,28,-1,29,143,2.47
1090,26,1,25,181,2.58
1091,26,-2,28,160,2.47
1093,25,-3,28,163,2.28
1094,26,-1,27,137,1.96
1097,27,-3,30,143,2.45
1098,26,-5,31,139,1.99
1100,25,-6,31,135,2.06
1101,23,-6,29,145,2.02
1102,21,-8,29,141,1.95
1104,21,-8,29,114,1.58
1105,24,-7,31,114,1.51
1107,25,-8,33,75,1.57
1108,26,-8,34,77,1.88
1109,25,-7,32,83,1.88
1110,25,-8,33,85,1.73
1112,25,-8,33,82,1.56
1114,26,-1,27,149,2.22
1116,28,-1,29,120,2.22
1119,29,-1,30,117,2.28
1120,27,-1,28,119,2
1121,26,-2,28,138,2.14
1123,27,-3,30,141,1.94
1124,25,-5,30,162,1.99
1126,23,-7,30,171,2.06
1127,26,-6,32,150,2.25
1128,24,-7,31,116,1.63
1129,23,-7,30,118,1.63
1131,25,-7,32,86,1.88
1132,26,-8,34,77,1.88
1133,24,-7,31,88,1.73
1134,24,-7,31,87,1.73
1136,25,-7,32,89,1.75
1137,27,0,27,122,2.39
1139,26,-2,28,142,2.21
1140,25,-3,28,153,2
1142,23,-3,26,164,2.14
1143,24,-5,29,160,2.14
1144,26,-4,30,167,2.2
1145,22,-7,29,178,2.18
1146,23,-6,29,170,2.02
1148,22,-8,30,157,2.02
1150,23,-7,30,134,1.63
1151,25,-8,33,96,1.63
1154,26,-8,34,66,1.69
1155,23,-8,31,90,1.59
1156,24,-7,31,92,1.75
1157,24,-7,31,97,1.75
1159,26,-1,27,132,2.39
1161,28,-1,29,114,2.33
1162,27,-1,28,135,2.19
1163,23,-3,26,167,2.26
1164,26,-3,29,157,2.14
1166,23,-6,29,179,2.2
1167,22,-7,29,180,2.2
1169,21,-8,29,183,2.18
1170,20,-8,28,186,2.18
1171,21,-8,29,143,1.56
1172,25,-8,33,95,1.56
1174,24,-7,31,92,1.58
1175,26,-8,34,61,1.72
1177,26,-8,34,67,1.59
1180,24,-6,30,93,1.56
1182,27,-9,36,32,1.23
1184,26,-1,27,132,2.39
1186,27,0,27,120,2.33
1187,27,-1,28,125,2.19
1190,23,-3,26,174,2.34
1192,27,-2,29,155,2.32
1194,28,-2,30,141,2.44
1195,21,-4,25,182,2.4
1197,21,-6,27,174,2.4
1198,22,-7,29,176,2.18
1199,20,-9,29,190,2.18
1201,22,-7,29,124,1.55
1203,24,-8,32,83,1.59
1205,27,-9,36,34,1.28
1208,27,-9,36,31,1.32
1209,26,-1,27,161,2.44
1210,27,-1,28,129,2.44
1212,25,-1,26,155,2.44
1214,25,-2,27,176,2.26
1216,28,-2,30,126,2.26
1217,28,-1,29,132,2.4
1218,24,-5,29,159,2.4
1220,26,-3,29,154,2.39
1222,21,-8,29,189,2.43
1224,21,-8,29,166,2.43
1226,24,-7,31,90,1.56
1228,24,-7,31,101,1.58
1229,27,-9,36,53,1.43
1231,27,-9,36,46,1.43
1233,27,-9,36,40,1.32
1234,27,-9,36,34,1.28
1235,27,-9,36,32,1.23
1236,26,0,26,165,2.71
1237,23,-2,25,201,2.44
1239,25,-1,26,164,2.41
1240,27,-1,28,151,2.41
1241,26,-2,28,136,2.41
1242,24,-3,27,157,2.54
1244,26,-3,29,152,2.54
1245,21,-8,29,165,2.05
1246,21,-8,29,155,2.05
1248,24,-7,31,88,2.05
1250,23,-7,30,96,1.49
1251,23,-7,30,85,1.49
1252,23,-7,30,96,1.62
1253,25,-7,32,60,1.52
1254,26,-8,34,51,1.55
1256,26,-8,34,40,1.32
1258,26,-8,34,35,1.23
1259,27,-9,36,31,1.23
1260,20,3,17,175,2.17
1261,26,-1,27,180,2.92
1262,22,-2,24,199,2.41
1264,27,-1,28,129,2.47
1266,27,-1,28,129,2.66
1268,22,-2,24,164,2.54
1269,23,-4,27,167,2.54
1271,24,-4,28,177,2.6
1273,21,-6,27,207,2.64
1275,22,-7,29,175,2.4
1276,21,-8,29,160,1.49
1278,25,-7,32,80,1.51
1279,23,-6,29,82,1.49
1280,24,-6,30,80,1.62
1282,26,-8,34,62,1.54
1283,26,-8,34,70,1.52
1284,25,-7,32,64,1.55
1286,25,-7,32,49,1.55
1288,26,-9,35,32,1.59
1290,27,-9,36,31,1.53
1292,27,-9,36,31,1.25
1293,26,-8,34,31,1.45
1296,21,2,19,187,2.17
1298,25,-1,26,179,2.92
1299,25,-1,26,183,3.08
1300,23,-2,25,188,2.5
1303,27,-1,28,129,2.66
1305,24,-3,27,146,2.54
1307,27,-2,29,141,2.64
1309,25,-2,27,159,2.64
1310,21,-7,28,201,2.37
1312,21,-7,28,192,2.4
1313,20,-9,29,207,1.72
1315,25,-7,32,74,1.72
1317,24,-7,31,78,1.56
1319,24,-7,31,103,1.86
1321,26,-7,33,67,1.58
1323,24,-7,31,69,1.55
1325,25,-7,32,81,1.81
1326,26,-8,34,31,1.59
1328,26,-9,35,31,1.59
1329,25,-8,33,32,1.59
1331,25,-7,32,30,1.49
1333,26,-8,34,28,1.43
1334,23,1,22,213,3.29
1335,23,2,21,232,3.01
1337,25,-1,26,162,3.06
1339,25,-1,26,182,2.92
1340,23,-2,25,189,2.5
1341,27,0,27,145,2.5
1343,26,-1,27,131,2.54
1344,27,-1,28,135,2.74
1345,26,-2,28,148,2.74
1347,21,-5,26,171,2.73
1348,21,-7,28,193,2.37
1350,21,-8,29,197,2.4
1351,21,-8,29,182,1.72
1352,24,-7,31,88,1.72
1354,25,-7,32,62,1.56
1356,25,-7,32,55,1.51
1358,26,-8,34,55,1.49
1359,26,-8,34,60,1.57
1361,22,-8,30,79,1.88
1362,22,-8,30,67,1.86
1363,26,-8,34,30,1.86
1364,24,-7,31,31,1.59
1365,26,-9,35,29,1.59
1367,26,-9,35,28,1.49
1368,27,-1,28,142,3.33
1371,26,0,26,161,2.98
1373,26,1,25,152,3.06
1375,26,-1,27,139,3.06
1376,27,-1,28,126,2.93
1377,26,-1,27,127,2.54
1379,25,-3,28,122,2.74
1380,26,-2,28,136,2.74
1381,21,-5,26,162,2.73
1383,20,-6,26,183,2.73
1384,21,-8,29,192,2.04
1385,23,-6,29,108,2.04
1387,23,-6,29,108,2.04
1389,25,-7,32,73,1.56
1391,26,-8,34,59,1.56
1393,26,-8,34,55,1.49
1395,25,-7,32,58,1.51
1396,26,-8,34,59,1.77
1397,24,-7,31,72,1.88
1401,26,-8,34,30,1.5
1402,26,-9,35,30,1.57
1403,26,-9,35,28,1.57
1404,26,-9,35,27,1.4
1405,25,2,23,194,3.33
1406,24,-1,25,168,3.33
1407,26,0,26,163,3.03
1408,27,-1,28,143,3.03
1409,27,-1,28,148,2.93
1411,26,-1,27,132,2.93
1414,26,-1,27,130,2.67
1415,23,-4,27,151,2.73
1416,21,-7,28,189,2.04
1418,21,-8,29,178,2.04
1419,23,-6,29,107,1.78
1421,25,-7,32,81,1.81
1422,25,-7,32,77,1.6
1424,26,-8,34,53,1.49
1426,26,-8,34,58,1.9
1427,25,-6,31,72,1.9
1428,22,-8,30,75,1.9
1429,22,-9,31,71,2.01
1432,26,-8,34,31,1.5
1435,26,-7,33,28,1.35
1436,23,2,21,211,3.33
1437,26,-1,27,151,3.67
1439,25,-1,26,161,3.33
1441,25,-2,27,168,3.36
1442,28,-1,29,142,2.93
1443,25,-2,27,140,2.67
1444,25,-3,28,142,2.67
1445,21,-3,24,156,2.67
1447,21,-4,25,168,2.52
1448,23,-5,28,163,2.52
1449,21,-6,27,187,2.4
1451,21,-7,28,176,2.4
1452,21,-7,28,138,1.78
1453,24,-7,31,80,1.78
1454,25,-7,32,76,1.64
1456,24,-7,31,86,1.6
1457,26,-7,33,60,1.64
1459,26,-8,34,55,1.65
1460,27,-8,35,58,1.9
1461,25,-6,31,83,1.9
1464,24,-7,31,51,2.01
1465,26,-6,32,39,2.01
1467,26,-7,33,31,1.44
1469,24,-7,31,29,1.42
1470,20,2,18,180,2.28
1471,24,2,22,215,3.79
1472,24,1,23,218,3.79
1473,27,1,26,230,3.27
1474,26,1,25,160,3.32
1476,26,0,26,166,3.33
1478,23,-3,26,217,3.36
1479,27,0,27,161,3.27
1480,28,-2,30,139,2.92
1482,27,-2,29,141,2.98
1484,27,-2,29,145,2.6
1485,25,-3,28,153,2.52
1486,26,-3,29,157,2.52
1487,20,-6,26,192,2.4
1488,20,-7,27,186,2.4
1489,22,-7,29,152,1.95
1490,23,-7,30,111,1.95
1491,24,-7,31,103,1.93
1493,24,-7,31,113,1.6
1494,25,-7,32,66,1.67
1496,26,-7,33,64,1.65
1498,27,-8,35,53,1.67
1499,27,-7,34,57,1.88
1500,26,-6,32,64,1.88
1503,25,-7,32,49,1.94
1505,26,-7,33,34,1.5
1506,23,2,21,229,3.79
1507,23,2,21,242,3.79
1508,25,-1,26,166,3.64
1510,26,0,26,166,3.33
1511,27,0,27,190,3.27
1512,24,-3,27,195,3.27
1513,25,-2,27,189,2.92
1514,26,-2,28,169,2.92
1516,22,-4,26,173,2.57
1518,24,-3,27,172,2.57
1519,24,-3,27,164,2.52
1520,25,-3,28,163,2.52
1522,21,-6,27,186,2.4
1523,21,-7,28,181,1.95
1524,23,-7,30,134,1.93
1525,22,-7,29,124,1.93
1527,24,-7,31,94,1.93
1528,27,-6,33,56,1.88
1529,26,-6,32,50,1.94
1532,27,-6,33,40,1.94
1533,24,2,22,208,3.47
1534,24,2,22,214,3.47
1535,23,2,21,223,3.79
1536,27,-1,28,144,3.66
1538,27,-1,28,150,3.5
1540,28,-1,29,166,3.58
1542,29,-1,30,183,3.02
1543,26,-1,27,180,2.92
1545,22,-3,25,210,2.98
1547,22,-4,26,185,2.48
1548,24,-3,27,177,2.48
1551,22,-4,26,176,2.59
1553,21,-5,26,185,2.46
1555,20,-7,27,209,2.46
1556,19,-8,27,168,1.93
1557,19,-8,27,168,1.93
1559,22,-7,29,116,1.86
1561,23,-7,30,102,1.93
1562,27,-6,33,38,2.45
1563,23,2,21,202,3.47
1565,23,2,21,210,3.47
1566,24,1,23,211,3.48
1567,27,0,27,173,3.5
1569,25,-2,27,213,3.5
1571,27,-1,28,201,2.92
1572,26,-1,27,196,2.92
1574,24,-3,27,213,2.87
1576,24,-3,27,187,2.77
1578,22,-4,26,192,2.78
1579,23,-4,27,180,2.52
1581,21,-6,27,220,2.46
1582,21,-8,29,234,2.14
1586,20,-8,28,171,2.14
1587,22,-7,29,111,2.02
1589,25,-6,31,56,1.81
1591,27,-6,33,36,1.86
1592,22,2,20,200,4.49
1594,24,1,23,205,3.39
1595,22,2,20,207,3.47
1597,27,1,26,205,3.37
1599,29,-1,30,186,2.89
1601,25,-2,27,204,2.87
1603,22,-4,26,214,2.73
1604,24,-3,27,177,2.73
1605,25,-4,29,174,2.75
1606,19,-8,27,132,2.02
1607,22,-7,29,102,2.02
1608,23,2,21,233,4.49
1610,21,2,19,229,3.39
1612,23,2,21,203,3.39
1614,25,1,24,204,3.21
1616,27,0,27,200,2.89
1617,26,-1,27,202,2.77
1619,22,-4,26,220,2.84
1620,23,-3,26,209,2.73
1621,23,-3,26,209,2.73
1623,22,-5,27,227,2.75
1625,20,-6,26,267,2.72
1627,18,-8,26,252,2.22
1628,19,-9,28,157,2.2
1630,22,-7,29,108,2.25
1632,27,-6,33,35,1.69
1634,21,2,19,230,3.07
1636,21,2,19,244,3.39
1637,23,0,23,218,3.54
1640,26,1,25,205,3.21
1641,26,1,25,200,3.63
1642,27,0,27,209,2.89
1645,28,-2,30,222,3.03
1647,27,-3,30,177,2.84
1648,25,-2,27,195,2.84
1650,23,-4,27,216,2.84
1652,21,-6,27,248,2.22
1655,20,-8,28,129,2.2
1657,24,-6,30,86,2.25
1661,20,2,18,260,3.7
1664,27,1,26,202,3.37
1666,26,1,25,200,3.47
1668,24,-3,27,236,3.45
1669,27,-1,28,220,3.33
1671,25,-2,27,232,2.84
1672,26,-3,29,207,2.84
1673,22,-5,27,238,2.84
1675,22,-6,28,248,2.43
1676,20,-8,28,248,2.41
1677,22,-7,29,118,2.27
1679,24,-6,30,80,2.27
1681,26,-6,32,51,2.16
1683,27,-6,33,39,1.57
1685,21,2,19,241,3.7
1686,23,1,22,225,3.93
1689,25,1,24,207,3.08
1691,24,-2,26,241,3.45
1692,24,-3,27,240,3.33
1693,26,-1,27,209,3.11
1694,22,-3,25,236,3.11
1697,21,-7,28,247,2.41
1699,22,-6,28,123,2.2
1700,22,2,20,239,3.94
1702,23,1,22,218,3.73
1703,23,2,21,233,3.35
1704,24,1,23,211,3.28
1705,23,-3,26,241,3.71
1706,23,-3,26,236,3.11
1708,26,-4,30,208,2.82
1710,21,-6,27,236,2.53
1712,24,-6,30,98,2.3
1713,24,-10,34,87,2.24
1715,21,2,19,196,3.73
1716,24,2,22,214,3.15
1718,23,-3,26,226,3.71
1719,22,-3,25,224,3.71
1721,26,-3,29,187,3.68
1723,23,-3,26,244,3.68
1725,22,-4,26,284,3.36
1727,22,-5,27,212,2.53
1729,22,-6,28,223,2.53
1730,22,-6,28,198,2.53
1732,25,-6,31,86,2.3
1734,27,-6,33,43,2.11
1735,21,-10,31,94,2.24
1737,21,2,19,239,3.15
1739,22,1,21,271,3.48
1741,26,-1,27,193,3.85
1743,23,-3,26,243,3.36
1745,25,-5,30,190,3.36
1747,23,-5,28,199,3.34
1749,22,-6,28,221,3.34
1752,25,-5,30,91,2.3
1756,22,2,20,232,2.75
1757,23,1,22,306,4.04
1758,24,2,22,265,4.04
1759,23,-2,25,240,3.66
1760,23,-3,26,232,3.61
1762,25,-3,28,203,3.45
1764,24,-5,29,199,3.36
1765,22,-6,28,210,3.34
1767,22,-6,28,216,2.72
1769,26,-6,32,77,2.72
1771,27,-6,33,51,2.2
1772,22,1,21,206,3.6
1773,23,1,22,229,3.6
1775,23,1,22,236,3.86
1776,26,2,24,204,3.63
1777,25,1,24,212,3.98
1778,24,-1,25,216,3.61
1780,22,-4,26,232,3.45
1781,25,-4,29,211,3.46
1783,21,-6,27,221,3.46
1785,22,-6,28,225,2.7
1787,26,-6,32,88,2.72
1788,27,-5,32,54,2.2
1790,24,-5,29,88,2.18
1791,25,-5,30,53,1.62
1792,25,-4,29,48,1.62
1793,22,-7,29,70,1.88
1795,25,0,25,223,3.75
1796,25,-1,26,233,3.75
1797,22,-3,25,259,3.75
1799,25,-4,29,211,3.46
1800,23,-4,27,220,3.46
1801,22,-5,27,218,3.06
1803,24,-5,29,152,3.06
1804,27,-6,33,52,2.38
1807,24,-6,30,99,2.18
1809,26,-4,30,46,1.76
1810,27,-4,31,40,1.76
1811,24,-1,25,245,3.75
1812,24,-1,25,207,3.59
1813,22,-4,26,247,3.44
1815,25,-4,29,208,3.46
1817,22,-5,27,218,3.04
1818,21,-6,27,209,3.06
1819,23,-7,30,171,2.38
1821,25,-4,29,73,2.35
1823,26,-4,30,47,1.81
1824,25,-2,27,226,3.59
1826,23,-4,27,220,3.11
1828,26,-1,27,213,3.63
1830,23,-3,26,198,3.25
1832,21,-4,25,214,3.11
1834,22,-5,27,220,3.11
1835,19,-7,26,250,3.11
1836,24,-1,25,237,3.52
1838,24,-1,25,229,3.52
1839,25,-2,27,185,3.23
1840,25,-3,28,181,3.23
1842,24,-4,28,196,3.11
1844,21,-5,26,214,3.11
1846,20,-6,26,212,2.84
1848,22,-3,25,245,4.04
1849,24,-2,26,235,4.04
1850,23,-3,26,237,4.04
1852,23,-4,27,203,3.19
1853,22,-5,27,198,3.19
1854,23,0,23,280,4.47
1856,20,-1,21,229,4.04
1858,22,-4,26,239,3.57
1859,21,-3,24,238,3.4
1860,22,-4,26,203,3.4
1861,24,-3,27,189,3.4
1863,22,-4,26,197,3.02
1865,23,-4,27,188,2.94
1866,21,-5,26,189,2.91
1867,24,-9,33,77,1.81
1868,21,2,19,298,3.94
1869,22,1,21,274,4.41
1871,24,-2,26,232,4.38
1872,23,-3,26,221,3.45
1876,24,-3,27,179,2.94
1878,22,-4,26,182,2.94
1879,20,-4,24,188,3.02
1881,22,-5,27,182,2.99
1882,21,0,21,277,4.41
1883,21,1,20,302,4.41
1884,21,-4,25,256,4.38
1885,25,-2,27,196,3.45
1887,25,-2,27,164,3.45
1889,23,-4,27,184,3.35
1891,23,-3,26,174,3.25
1893,24,-4,28,166,3.09
1895,22,-5,27,177,2.99
1896,21,-10,31,86,1.99
1898,21,-3,24,222,3.45
1900,25,-2,27,159,3.38
1901,25,-2,27,160,3.35
1902,25,-3,28,163,3.35
1905,21,-5,26,183,3.42
1906,23,-9,32,76,1.76
1907,22,0,22,263,4.04
1908,24,-3,27,158,3.91
1910,23,-4,27,163,3.35
1912,24,-4,28,161,3.28
1914,23,-5,28,153,3.28
1915,24,-7,31,69,1.78
1916,21,0,21,265,4.04
1918,20,-3,23,283,5.71
1919,21,-2,23,230,4.32
1921,21,-3,24,210,4.21
1923,25,-1,26,180,4.07
1924,20,-4,24,205,4.07
1925,23,-3,26,167,3.9
1927,22,-4,26,164,3.9
1929,23,-5,28,144,3.73
1930,21,1,20,273,4.22
1931,22,0,22,213,5.52
1933,22,-4,26,230,5.12
1934,23,-4,27,228,4.07
1936,21,-4,25,184,3.73
1937,20,-5,25,185,3.9
1939,22,-5,27,155,3.57
1941,21,-5,26,144,3.74
1943,23,-5,28,109,3.57
1945,23,-5,28,94,3.17
1946,24,-5,29,79,3.37
1947,20,-10,30,148,3.2
1948,20,1,19,332,4.22
1949,19,1,18,317,4.22
1950,21,0,21,215,4.12
1951,22,0,22,180,5.52
1952,22,-1,23,218,5.3
1954,20,-4,24,223,5.3
1955,21,-4,25,228,5.3
1956,21,-4,25,205,4.92
1958,23,-4,27,180,4.92
1960,21,-4,25,167,4.42
1961,20,-5,25,162,3.74
1963,21,-5,26,160,3.17
1965,21,-5,26,126,3.37
1967,23,-5,28,100,3.17
1969,26,-5,31,48,2.35
1970,27,-4,31,43,2.35
1971,19,-11,30,168,3.2
1972,22,1,21,242,2.22
1973,22,1,21,241,4.07
1974,21,0,21,252,4.24
1976,25,0,25,236,3.79
1978,22,-2,24,233,6.26
1980,21,-4,25,268,4.69
1981,21,-4,25,231,4.92
1983,23,-2,25,204,3.97
1984,20,-5,25,207,4.92
1986,19,-5,24,202,4.68
1987,19,-5,24,194,4.13
1988,19,-5,24,194,4.13
1989,20,-5,25,141,2.35
1993,27,-4,31,42,2.35
1994,17,-11,28,153,2.6
1995,22,-10,32,153,2.6
1996,17,-12,29,166,2.63
1997,20,-12,32,166,3.2
1999,24,-10,34,133,3
2001,24,-9,33,127,3
2002,21,1,20,257,4.07
2003,21,1,20,265,4.24
2005,23,-2,25,219,6.26
2007,20,-4,24,315,6.51
2009,21,-2,23,239,6.21
2011,22,-2,24,228,4.92
2013,22,-3,25,219,5.38
2015,21,-4,25,209,4.68
2017,19,-5,24,251,4.68
2019,19,-5,24,231,3.91
2021,19,-5,24,240,3.91
2022,24,-5,29,108,3.3
2023,22,-5,27,67,3.3
2025,24,-8,32,112,2.9
2027,24,-10,34,108,2.51
2028,17,-12,29,174,2.63
2029,20,-11,31,153,2.63
2031,19,-12,31,129,2.83
2032,22,-2,24,227,6.21
2034,21,-4,25,264,5.38
2036,20,-4,24,240,5.38
2038,18,-6,24,293,4.36
2041,22,-5,27,194,4.13
2043,19,-5,24,155,3.12
2045,22,-5,27,63,3.3
2047,21,-11,32,136,2.99
2049,25,-9,34,104,2.68
2050,18,-13,31,158,2.63
2051,19,-12,31,110,2.63
2052,18,-12,30,116,2.83
2054,25,0,25,200,7.02
2055,22,-1,23,276,7.02
2056,21,-2,23,317,7.12
2057,20,-4,24,293,7.12
2058,22,-3,25,291,5.38
2060,20,-4,24,273,5.38
2064,19,-6,25,316,4.17
2065,22,-4,26,172,4.09
2067,20,-5,25,138,4.09
2069,23,-5,28,63,3.84
2071,22,-10,32,124,3.06
2072,21,-11,32,132,3.21
2073,25,-9,34,100,2.95
2075,20,-12,32,146,2.95
2077,23,-9,32,116,2.29
2079,22,-10,32,116,2.29
2081,18,-11,29,119,2.27
2083,25,-1,26,205,7.02
2084,22,-2,24,274,7.12
2085,21,-4,25,321,7.12
2086,21,-2,23,288,7.12
2087,21,-4,25,305,5.87
2088,22,-5,27,267,4.36
2090,22,-5,27,197,4.36
2091,24,-4,28,123,4.09
2092,22,-5,27,110,4.09
2095,23,-10,33,103,3.52
2096,26,-8,34,90,2.93
2097,19,-11,30,136,3.25
2098,18,-11,29,146,3.25
2101,23,-9,32,95,2.29
2103,23,-2,25,267,7.4
2105,23,-1,24,271,7.4
2106,23,-2,25,267,7.87
2108,22,-2,24,276,5.55
2109,22,-3,25,298,5.87
2110,22,-3,25,262,5.87
2114,24,-4,28,124,4.36
2116,21,-5,26,146,3.98
2118,26,-8,34,77,2.93
2119,19,-11,30,111,3.25
2121,22,-10,32,85,2.9
2122,18,-11,29,112,2.13
2124,23,-2,25,263,7.4
2126,19,-6,25,316,4.17
2127,21,-4,25,316,6.47
2128,21,-4,25,299,6.47
2130,22,-3,25,211,5.34
2132,24,-8,32,97,2.66
2133,20,-10,30,83,2.66
2134,21,-4,25,294,6.47
2135,22,-2,24,281,6.47
2136,22,-5,27,237,5.34
2137,23,-4,27,158,5.34
2139,23,-9,32,74,2.59
2141,21,-4,25,256,6.51
2142,21,-5,26,243,5.34
2144,21,-5,26,203,5.34
2145,21,-3,24,459,8.82
2147,22,-4,26,214,5.45
2148,21,-2,23,460,6.93
2149,21,-4,25,368,7.24
2152,23,-3,26,325,5.34
2154,24,-2,26,287,5.34
2156,27,-2,29,243,5.34
2158,25,-3,28,275,4.73
2159,25,-3,28,277,5.12
2161,25,-3,28,188,3.82
2162,29,-4,33,50,1.85
2163,22,-3,25,415,6.93
2165,20,-4,24,371,6.52
2167,24,-2,26,276,5.11
2169,25,-3,28,233,5.11
2170,25,-2,27,254,5.12
2171,23,-3,26,280,5.12
2173,22,-4,26,275,4.73
2175,24,-3,27,215,3.82
2176,24,-4,28,151,4.15
2177,25,-6,31,100,3.4
2178,24,-2,26,358,6.93
2179,23,-2,25,351,6.93
2181,22,-2,24,271,5.11
2183,25,-2,27,246,5.11
2185,21,-4,25,244,3.7
2186,21,-5,26,198,3.7
2188,24,-3,27,154,3.82
2189,25,-2,27,354,5.81
2190,22,-2,24,348,5.81
2192,22,-3,25,273,5.11
2193,22,-2,24,276,5.07
2194,19,-5,24,282,5.07
2196,22,-4,26,228,3.7
2198,22,-4,26,183,3.7
2199,24,-4,28,152,2.81
2200,24,-4,28,152,2.62
2201,21,-3,24,346,4.69
2203,22,-3,25,310,4.49
2205,21,-4,25,302,4.49
2207,22,-3,25,265,4.16
2208,19,-5,24,304,4.37
2209,19,-5,24,268,3.98
2212,22,-4,26,145,2.62
2213,24,-6,30,92,2.39
2214,25,-3,28,283,4.37
2217,22,-3,25,260,4.16
2218,20,-5,25,259,4.37
2219,19,-6,25,270,3.98
2220,21,-5,26,224,3.77
2222,22,-4,26,145,3.11
2223,24,-2,26,348,4.88
2225,25,-3,28,269,3.58
2227,23,-4,27,259,3.58
2229,21,-4,25,253,3.43
2231,19,-6,25,250,3.77
2232,22,-4,26,236,3.77
2234,21,-4,25,203,3.11
2235,22,-4,26,236,3.77
2236,21,-5,26,160,2.75
2237,30,-5,35,57,1.82
2239,21,-3,24,335,5.26
2241,21,-3,24,359,5.26
2243,19,-3,22,412,3.83
2245,22,-3,25,397,3.97
2246,24,-3,27,283,4.16
2247,24,-4,28,261,3.71
2248,25,-3,28,257,3.58
2250,20,-4,24,254,3.43
2251,19,-5,24,252,3.43
2253,21,-4,25,246,3.69
2255,21,-4,25,231,3.69
2257,18,-7,25,201,3.11
2259,18,-8,26,227,2.75
2260,21,-3,24,269,3.63
2261,19,-4,23,267,3.63
2263,23,-4,27,253,3.43
2265,24,-5,29,250,3.43
2267,22,-4,26,246,3.69
2269,19,-6,25,271,3.69
2271,20,-3,23,262,3.47
2272,18,-5,23,269,3.61
2274,19,-5,24,242,3.27
2276,16,-8,24,264,2.71
2279,22,-7,29,138,2.83
2282,18,-4,22,259,3.53
2283,17,-5,22,283,3.61
2284,18,-5,23,265,3.61
2285,20,-5,25,234,3.39
2287,22,-4,26,184,3.39
2288,19,-6,25,176,3.39
2289,19,-7,26,172,3.08
2291,17,-8,25,171,2.95
2294,21,-3,24,242,3.53
2296,20,-4,24,252,3.35
2297,17,-5,22,256,3.35
2298,20,-4,24,201,3.35
2299,25,-4,29,191,3.39
2301,23,-4,27,168,3.08
2302,19,-6,25,168,3.08
2303,21,-3,24,248,3.82
2304,16,-4,20,259,3.44
2305,23,-3,26,216,3.53
2306,20,-4,24,248,3.35
2307,25,-4,29,203,3.35
2308,18,-6,24,170,3.06
2310,23,-6,29,166,3.06
2311,19,-7,26,171,2.66
2312,24,-2,26,191,3.44
2313,24,-2,26,172,3.02
2315,26,-2,28,175,3.02
2316,21,-4,25,204,3.35
2317,23,-4,27,182,3.35
2318,21,-5,26,168,3.06
2319,21,-5,26,164,3.06
2321,19,-7,26,171,2.66
2322,25,-1,26,164,3.02
2324,24,-2,26,174,3.02
2325,21,-3,24,219,3.23
2327,19,-4,23,197,3.23
2328,19,-4,23,186,3.4
2329,20,-5,25,191,3.4
2330,18,-7,25,192,3.4
2331,18,-7,25,200,2.66
2333,24,-2,26,163,3.23
2334,22,-3,25,188,3.4
2336,22,-4,26,182,3.4
2337,18,-6,24,193,2.94
2339,20,-4,24,205,3.47
2340,20,-4,24,222,2.95
2341,23,-3,26,178,2.95
2342,20,-4,24,186,2.56
2344,19,-7,26,165,2.94
2345,23,-2,25,227,4.48
2346,23,-2,25,227,4.48
2347,19,-5,24,232,2.95
2349,21,-4,25,219,2.95
2350,22,-4,26,206,2.95
2352,25,-3,28,159,2.56
2354,19,-6,25,198,2.87
2355,23,-5,28,158,2.87
2356,19,-7,26,154,2.56
2357,22,-2,24,222,5.17
2358,20,-5,25,244,3.15
2359,21,-5,26,210,3.15
2360,20,-5,25,215,2.51
2361,19,-5,24,225,2.51
2362,25,-3,28,156,2.56
2364,24,-4,28,193,2.87
2365,17,-8,25,167,1.92
2366,18,-8,26,159,1.84
2367,23,-1,24,177,5.17
2368,23,-2,25,186,3.76
2370,23,-4,27,205,3.15
2372,17,-6,23,267,2.51
2373,19,-6,25,236,2.2
2374,18,-7,25,204,2.2
2375,19,-5,24,233,3.74
2376,18,-8,26,169,1.65
2378,23,-6,29,129,1.86
2382,20,-7,27,310,2.93
2385,23,-6,29,217,2.94
2387,19,-4,23,308,4.07
2394,17,-10,27,244,2.4
2395,26,-8,34,122,2.29
2400,20,-5,25,329,4.13
2402,25,-8,33,155,1.98
2403,22,-7,29,274,3.09
2409,25,-9,34,152,1.93
2410,17,-10,27,212,1.72
2412,21,-8,29,272,2.69
2413,16,-10,26,144,1.72
2414,22,-8,30,218,2.09
2416,25,-7,32,242,2.94
2418,20,-9,29,121,1.72
2422,24,-8,32,72,1.59
2426,16,-10,26,134,1.81
2432,19,-10,29,78,1.28
2434,18,-10,28,137,2.15
2435,20,-12,32,83,1.6
2438,18,-11,29,95,1.67
2439,15,-11,26,98,1.86
2440,19,-12,31,86,1.57
2441,20,-12,32,74,1.57
2446,18,-11,29,139,2.82
2447,17,-12,29,154,2.82
2449,24,-7,31,110,1.99
2450,20,-5,25,240,3.15
2452,20,-5,25,235,3.15
2453,19,-5,24,228,3.76
2454,22,-4,26,214,3.15
2455,23,-3,26,207,3.15
2456,19,-5,24,211,3.76
2458,22,-4,26,206,3.15
2459,23,-4,27,201,3.15
2461,19,-5,24,254,3.15
2462,23,-2,25,186,3.15
2463,22,-3,25,188,3.95
2464,21,-5,26,204,3.74
2467,25,-8,33,60,1.65
2468,24,-8,32,79,2.08
2471,26,-8,34,56,1.85
2472,28,-7,35,70,2.72
2473,27,-11,38,50,2.04
2474,26,-10,36,57,1.85
2475,26,-9,35,65,1.98
2476,25,-6,31,52,1.71
2477,25,-7,32,52,1.65
2479,24,-6,30,67,2.43
2480,29,-4,33,32,1.68
2482,20,-11,31,114,2.52
2483,28,-8,36,56,2.08
2484,27,-4,31,54,3.06
2485,26,-7,33,120,4.06
2486,23,-6,29,70,2.15
2487,22,-7,29,94,2.29
2488,21,-8,29,105,3.32
2489,28,-6,34,48,2.23
2490,22,-9,31,136,2.66
2491,24,-7,31,80,2.05
2492,27,-7,34,55,2.01
2493,29,-6,35,46,1.93
2494,26,-10,36,45,1.71
2495,24,-9,33,62,1.76
2496,26,-9,35,39,1.72
2497,22,-11,33,54,1.52
2498,18,-10,28,60,2.25
2499,23,-10,33,59,2.43
2504,23,-6,29,84,1.04
2506,28,-8,36,41,1.63
2508,22,-7,29,80,2.28
2510,25,-6,31,122,1.82
2511,27,-8,35,54,1.66
2515,26,-7,33,74,1.8
2516,25,3,22,365,3.69
2517,25,-1,26,133,2.85
2519,28,-8,36,54,1.6
2522,30,-1,31,105,2.34
2524,29,0,29,108,2.24
2525,26,-7,33,76,1.5
2527,27,-1,28,114,2.3
2530,28,-2,30,134,2.35
2534,29,0,29,109,2.42
2536,24,-5,29,162,2.22
2538,28,0,28,117,2.4
2540,23,-6,29,165,2.22
2541,26,-1,27,131,2.44
2543,26,-8,34,73,1.69
2544,28,-1,29,136,2.72
2546,27,-2,29,141,1.96
2549,27,-2,29,132,1.94
2552,26,-4,30,150,2.14
2556,24,-7,31,90,1.58
2557,27,-3,30,156,2.2
2558,25,-8,33,74,1.72
2561,22,-3,25,175,2.14
2563,24,-8,32,96,1.56
2564,23,-7,30,116,2.05
2567,25,-3,28,180,2.6
2568,25,-7,32,78,1.88
2570,23,-7,30,55,1.55
2572,25,-6,31,84,1.88
2573,24,-7,31,41,1.86
2580,28,-1,29,125,2.93
2588,26,-8,34,29,1.57
2591,24,-7,31,66,1.94
2593,25,-7,32,65,1.88
2596,21,-7,28,195,1.95
2599,21,-4,25,179,2.52
2601,26,-6,32,64,1.86
2604,27,-2,29,182,2.77
2607,25,1,24,209,3.48
2609,22,-4,26,219,2.73
2611,27,1,26,202,3.37
2612,20,-8,28,119,2.25
2615,29,-2,31,169,2.84
2623,25,-3,28,204,2.84
2627,26,-2,28,208,3.11
2628,26,-4,30,205,2.82
2630,22,-5,27,221,2.84
2632,23,-3,26,233,3.11
2634,23,-3,26,244,2.82
2635,21,-7,28,237,3.06
2640,26,2,24,210,3.65
2649,25,-4,29,201,2.82
2654,25,1,24,250,3.65
2655,24,-6,30,175,2.7
2656,24,-6,30,175,2.7
2657,26,-5,31,62,2.24
2661,21,-10,31,104,1.69
2662,22,1,21,206,3.38
2667,25,1,24,230,3.76
2669,20,-7,27,241,3.32
2672,25,-2,27,191,3.45
2674,21,-6,27,222,3.46
2675,22,-3,25,257,3.45
2678,23,-3,26,234,3.45
2679,22,-3,25,286,3.59
2682,23,-3,26,231,3.59
2684,24,-3,27,203,3.44
2688,22,-4,26,200,3.23
2690,24,-2,26,195,3.15
2693,23,-4,27,171,3.28
2694,20,0,20,240,2.17
2697,25,-1,26,166,4.07
2701,21,-2,23,212,5.52
2708,22,-9,31,120,2.6
2710,17,-7,24,319,3.79
2713,19,-11,30,117,2.34
2715,21,-4,25,369,7.87
2717,23,-9,32,87,3.14
2720,23,-3,26,267,5.07
2723,22,-3,25,266,5.07
2727,20,-4,24,314,4.69
2742,22,-7,29,109,2.83
2743,18,-4,22,341,5.5
2746,24,-3,27,256,3.63
2748,20,-3,23,254,3.63
2749,18,-5,23,277,3.61
2752,20,-6,26,202,3.84
2753,21,-7,28,110,2.39
2754,26,-8,34,104,3.07
2756,24,-3,27,203,3.35
2759,18,-5,23,195,3.35
2762,18,-6,24,194,2.94
2764,20,-6,26,182,2.87
2765,19,-5,24,216,3.74
2766,17,-6,23,227,3.44
2768,18,-11,29,189,2.54
2770,20,-4,24,340,6.44
2776,19,-4,23,299,3.91
2778,22,-6,28,277,3.09
2780,19,-10,29,254,2.27
2782,19,-10,29,148,1.72
2784,19,-10,29,87,1.87
2790,16,-11,27,91,1.6
2791,23,-12,35,64,1.28
2792,21,-10,31,78,1.8
2802,16,-10,26,134,1.8
2803,27,-4,31,50,3.2
2810,26,-4,30,51,3.2
2813,17,-7,24,319,4.07
2814,26,1,25,186,4.06
2820,27,1,26,171,4.06
2827,26,1,25,183,4.06
2834,27,1,26,165,4.06
2841,26,1,25,183,4.06
2848,26,0,26,182,4.06
2855,26,0,26,157,3.72
2856,30,-7,37,34,1.54
2859,27,1,26,117,4.77
2860,24,1,23,97,12.3
2865,29,-1,30,43,3.43
2867,28,-1,29,52,3.43
2869,27,-1,28,64,3.43
2871,26,0,26,127,6.77
2875,26,0,26,159,6.77
2880,26,0,26,162,6.77
2883,27,0,27,93,5.45
2886,27,0,27,77,5.45
2889,27,-1,28,75,3.96
2892,26,1,25,180,6.51
2895,26,0,26,200,6.51
2898,27,0,27,82,5.45
2901,29,-1,30,42,3.43
2905,29,-1,30,43,3.43
2915,27,-1,28,76,3.96
2918,28,-1,29,69,4.24
2922,27,-1,28,79,4.24
2925,26,0,26,194,6.51
2928,26,1,25,181,6.51
2931,26,0,26,187,7.98
2933,27,1,26,156,7.4
2935,25,0,25,192,7.99
2956,30,-1,31,39,3.43
2958,30,-1,31,49,3.43
2960,28,-1,29,54,3.43
2962,26,1,25,180,7.27
2966,26,1,25,170,7.27
2969,26,1,25,174,7.27
2971,27,-1,28,120,5.45
2973,28,-1,29,77,5.45
2976,26,0,26,109,5.45
2978,28,-1,29,90,5.45
2981,27,0,27,75,3.96
2984,28,-1,29,70,4.24
2987,28,0,28,76,4.24
2989,27,-1,28,79,4.24
2994,26,0,26,180,6.77
2996,25,0,25,210,7.99
2998,26,1,25,180,7.99
3000,26,1,25,121,7.98
3003,27,1,26,131,7.66
3006,26,1,25,160,7.4
3008,26,1,25,184,7.4
3010,26,1,25,181,7.4
3012,26,1,25,196,7.87
3014,26,0,26,211,7.27
3016,26,1,25,194,6.51
3018,26,0,26,191,6.51
3025,27,-3,30,45,2.92
3028,28,-2,30,59,2.89
3032,28,-1,29,61,2.89
3037,26,-3,29,86,3.63
3038,30,-2,32,52,3.25
3039,30,-2,32,53,3.25
3040,24,2,22,92,11.7
3041,27,1,26,109,5.39
3042,27,1,26,108,5.39
3043,30,-4,34,39,1.79
3044,27,1,26,116,5.9
3046,31,-1,32,51,3.72
3047,27,-6,33,30,2.45
3048,27,-6,33,30,2.45
3049,27,-6,33,31,2.45
3052,30,-6,36,42,2.04
3053,29,-8,37,35,1.89
3054,29,-6,35,38,1.4
3056,22,-7,29,138,3.49
3057,24,-6,30,103,3.49
3058,24,-6,30,124,3.93
3059,27,-5,32,106,3.93
3060,22,-7,29,146,3.93
3061,31,-3,34,21,3.05
3064,18,-10,28,140,2.89
3065,28,-7,35,49,1.72
3066,29,-5,34,61,2.21
3067,21,-8,29,90,1.88
3068,23,1,22,112,13.25
3105,26,0,26,202,7.02
3106,26,0,26,202,7.02
3107,26,0,26,202,7.02
3108,25,-12,37,29,2.17
3109,25,-13,38,31,2.16
3112,23,-2,25,241,5.14
3116,26,1,25,183,3.29
3119,26,0,26,151,3.16
3122,21,2,19,252,3.16
3125,24,-5,29,145,2.16
3128,25,1,24,159,3.77
3131,26,0,26,127,3.61
3134,25,0,25,130,6.67
3137,27,0,27,119,5.49
3140,28,-2,30,224,3.2
3146,22,0,22,226,4.38
3149,21,-1,22,283,3.08
3151,27,-3,30,193,2.61
3154,24,2,22,92,11.46
3157,26,0,26,118,11.19
3161,28,-6,34,76,2.24
3164,24,-1,25,249,5.28
3189,30,-7,37,28,2.46
3190,24,1,23,107,8.17
3191,23,-6,29,110,2.77
3192,22,-7,29,119,2.77
3193,23,-6,29,113,2.77
3194,24,-6,30,106,2.73
3195,24,-6,30,105,2.83
3196,30,-6,36,41,1.83
3200,26,-5,31,58,2.38
3201,26,2,24,298,2.19
3202,31,-1,32,51,3.72
3203,22,0,22,94,8.32
3204,24,1,23,146,9.15
3205,32,-4,36,42,2.25
3207,31,-1,32,46,3.72
3222,26,1,25,181,7.99
3226,25,0,25,215,7.27
3230,25,0,25,199,7.27
3234,24,-1,25,236,7.27
3239,25,-1,26,225,7.27
3247,20,-4,24,338,7.87
3250,23,-2,25,295,7.27
3253,23,-2,25,301,7.27
3256,27,-1,28,77,3.96
3257,26,-2,28,80,3.96
3258,27,-1,28,76,3.96
3260,27,-1,28,77,3.25
3262,26,-2,28,81,3.96
3265,26,-3,29,86,4.19
3267,27,-2,29,81,5.45
3269,27,-1,28,82,5.45
3270,25,-4,29,93,5.45
3272,25,-4,29,112,5.45
3274,25,-4,29,113,5.45
3276,25,-3,28,94,5.45
3278,26,-2,28,89,5.45
3280,26,-2,28,86,5.45
3281,27,0,27,88,5.45
3283,26,-2,28,86,5.45
3284,28,-1,29,71,4.24
3286,27,-1,28,64,3.43
3288,27,-2,29,63,3.43
3289,28,-1,29,57,3.43
3291,28,-1,29,52,3.43
3292,28,-2,30,46,3.43
3294,27,-3,30,53,3.43
3295,27,0,27,75,3.96
3296,27,0,27,74,3.96
3297,28,-1,29,76,4.24
3298,27,-2,29,65,3.43
3301,28,-2,30,58,3.43
3302,28,-2,30,60,3.43
3303,26,-4,30,68,3.82
3304,28,-1,29,64,4.24
3305,28,-2,30,79,4.24
3309,26,0,26,202,7.27
3312,26,-1,27,228,6.51
3314,26,-1,27,232,4.75
3317,26,0,26,215,6.51
3319,26,-2,28,80,3.96
3320,26,0,26,210,6.51
3322,24,-1,25,235,6.51
3326,25,-1,26,231,6.47
3329,25,-1,26,236,6.47
3333,26,-3,29,82,3.96
3336,23,-1,24,296,7.87
3338,26,0,26,146,6.77
3341,27,-1,28,100,5.45
3343,26,-1,27,181,6.77
3345,26,-2,28,195,6.77
3348,26,-1,27,169,6.77
3351,23,-1,24,268,7.4
3353,25,-4,29,86,3.96
3356,22,-3,25,316,7.87
3359,21,-4,25,350,7.87
3361,26,-4,30,85,3.96
3364,26,-3,29,80,3.63
3366,26,-4,30,87,3.96
3369,26,-4,30,90,3.25
3371,29,-2,31,42,3.43
3373,28,-2,30,44,3.43
3375,29,-1,30,46,3.43
3377,27,-3,30,43,2.89
3379,28,-3,31,41,3.43
3382,25,0,25,197,6.51
3419,26,-7,33,86,1.82
3422,27,-9,36,44,1.58
3423,27,0,27,129,4.02
3424,26,1,25,111,8.44
3425,28,-7,35,55,1.83
3426,26,1,25,100,9.11
3427,24,1,23,92,2.95
3428,24,1,23,97,12.3
3430,27,-7,34,51,1.04
3431,20,-6,26,169,2.73
3432,24,-6,30,105,2.73
3434,27,1,26,118,5.74
3435,27,1,26,117,5.9
3436,27,1,26,115,6.1
3437,27,1,26,118,4.77
3438,27,1,26,118,5.74
3439,27,1,26,131,3.81
3440,27,1,26,133,3.81
3441,31,-1,32,48,2.93
3442,26,-3,29,80,4.24
3443,26,-2,28,95,5.45
3444,28,-3,31,49,3.46
3445,29,-3,32,43,2.5
3446,26,-3,29,144,4.15
3447,24,-4,28,109,5.45
3448,27,-2,29,112,5.45
3451,24,-1,25,331,8.82
3452,22,-4,26,334,7.27
3454,25,-1,26,207,6.51
3455,25,-1,26,186,6.51
3457,26,0,26,243,7.99
3458,24,0,24,343,8.82
3461,28,1,27,85,3.46
3462,23,-6,29,219,2.72
3463,26,1,25,120,8.88
3464,25,0,25,131,8.41
3465,25,0,25,125,12.78
3466,30,-6,36,31,2.03
3469,27,1,26,119,4.28
3470,27,1,26,117,4.28
3471,24,0,24,373,2.19
3472,22,-8,30,157,2.27
3473,22,-7,29,247,2.69
3474,24,-3,27,261,3.92
3475,18,-10,28,266,2.42
3477,18,-6,24,246,3.32
3479,28,1,27,88,4.16
3480,32,-5,37,46,2.18
3494,26,-11,37,31,3.41
3496,27,-11,38,31,2.67
3498,27,-1,28,182,6.33
3505,28,-5,33,66,3.23
3506,28,-2,30,224,3.33
3507,28,-2,30,223,3.33
3508,28,-2,30,223,3.33
3509,28,-2,30,224,3.33
3510,28,-2,30,223,3.33
3511,28,-2,30,223,3.33
3551,24,-9,33,92,1.57
3552,24,-9,33,92,1.57
3553,31,-1,32,52,3.44
3554,31,-1,32,52,3.44
3560,25,-10,35,43,1.81
3561,25,-10,35,43,1.81
3562,30,-6,36,42,2.04
3563,31,-3,34,21,8.93
3564,27,1,26,111,4.94
3565,27,0,27,114,4.94
3566,27,1,26,112,4.94
3568,27,0,27,113,4.94
3569,26,0,26,114,4.94
3605,24,1,23,96,13.25
3606,26,1,25,113,10.41
3607,30,-2,32,59,3.72
3608,26,-8,34,56,1.71
3609,28,-8,36,47,1.71
3610,26,-8,34,58,1.7
3611,26,-7,33,57,1.7
3612,25,-8,33,61,1.7
3613,27,-7,34,53,1.71
3614,29,-7,36,46,1.71
3615,28,-8,36,46,1.71
3616,24,0,24,382,3.16
3628,24,2,22,102,13.25
3629,24,1,23,100,11.03
3630,29,-6,35,47,1.93
3631,30,-6,36,48,1.93
3632,34,-3,37,42,2.41
3634,32,-4,36,44,2.41
3636,32,-4,36,42,2.28
3637,31,-4,35,46,2.41
3638,26,-7,33,79,1.7
3640,34,-3,37,41,1.87
3641,31,-5,36,46,2.21
3644,33,-3,36,41,1.87
3646,29,-5,34,48,1.87
3647,26,-10,36,46,1.72
3648,26,-7,33,66,2.74
3649,29,-5,34,49,2.74
3652,30,-7,37,45,1.34
3653,28,-7,35,47,1.52
3655,25,0,25,124,4.74
3656,32,-3,35,39,1.97
3657,32,-4,36,39,2.28
3658,32,-3,35,39,2.28
3659,32,-4,36,40,2.28
3660,25,-6,31,96,3.49
3661,25,-6,31,100,3.49
3662,19,-10,29,103,2.35
3663,19,-9,28,104,2.35
3664,20,-9,29,96,2.17
3665,22,-9,31,90,2.17
3666,30,-2,32,53,3.25
3668,25,0,25,121,6.46
3669,23,0,23,145,7.23
3670,28,-1,29,57,3.2
3674,30,-7,37,47,1.66
3675,30,-7,37,49,1.66
3676,27,1,26,120,4.38
3694,26,0,26,151,4.12
3696,24,2,22,94,13.25
3697,32,-7,39,26,3.32
3699,26,-7,33,80,1.7
3700,23,-6,29,82,1.9
3737,23,0,23,105,4.83
3740,24,1,23,98,13.25
3745,25,0,25,126,6.23
3748,24,-9,33,52,3.68
3749,28,-8,36,36,2.97
3750,28,-9,37,35,3.25
3751,23,-10,33,87,2.05
3753,27,-7,34,39,2.62
3754,20,-1,21,302,3.98
3762,29,-5,34,48,2.74
3763,29,-8,37,30,2.15
3764,17,-11,28,121,2.4
3822,26,1,25,116,12.78
3823,26,0,26,181,6.43
3828,30,-5,35,35,1.96
3829,28,-7,35,58,1.83
3831,16,-9,25,333,4.28
3836,24,-1,25,220,3.29
3841,24,-1,25,217,3.29
3850,24,-1,25,217,3.37
3851,23,-2,25,232,3.37
3852,24,-1,25,220,3.37
3853,24,-1,25,220,3.37
3854,24,-1,25,220,3.37
3855,24,-1,25,220,3.37
3865,20,-10,30,79,1.88
3881,29,-6,35,54,1.82
3884,24,1,23,174,3.02
3889,20,3,17,175,3.58
3891,19,3,16,171,3.79
3902,19,3,16,168,3.79
3904,20,3,17,175,2.15
3906,19,3,16,162,1.91
3908,20,3,17,171,2.05
3909,27,-7,34,59,2.06
3910,27,-7,34,64,2.06
3914,22,0,22,372,2.09
3915,22,0,22,381,2.19
3917,23,0,23,347,2.09
3918,22,0,22,381,2.19
3919,22,0,22,372,2.19
3921,23,0,23,367,2.09
3922,27,-7,34,72,1.8
3923,28,-7,35,69,1.8
3924,24,1,23,107,9.28
3925,28,-6,34,40,1.81
3927,26,1,25,153,7.66
3928,23,-1,24,112,4.55
3930,23,-1,24,129,4.55
3933,23,-2,25,126,4.55
3934,23,-1,24,112,4.55
3935,23,-2,25,122,4.55
3972,21,-4,25,377,7.87
3974,24,0,24,234,6.98
3977,30,-6,36,41,2.2
3979,25,0,25,127,6.23
3981,34,-2,36,40,1.87
3982,32,-4,36,43,2.21
3984,34,-2,36,40,2.21
3987,31,-5,36,45,1.85
3990,25,-4,29,101,5.09
3993,28,-3,31,77,3.44
3994,25,1,24,129,6.46
3995,26,0,26,121,12.78
3996,24,1,23,106,11.78
3997,31,0,31,81,2.49
3999,31,0,31,81,2.76
4002,27,-2,29,86,3.98
4006,25,-1,26,162,2.09
4007,23,-8,31,86,2.21
4008,20,-10,30,86,1.72
4009,27,0,27,160,3.71
4012,25,0,25,130,4.19
4013,27,1,26,110,12.78
4016,23,1,22,99,11.03
4017,27,1,26,101,7.63
4018,27,1,26,101,7.63
4019,18,-11,29,153,2.41
4020,18,-10,28,188,4.03
4021,19,-9,28,183,4.03
4022,24,-8,32,98,4.59
4023,27,1,26,115,7.98
4024,25,1,24,124,6.08
4025,25,1,24,121,5.79
4026,25,0,25,139,4.69
4027,23,1,22,100,2.39
4028,24,2,22,92,11.7
4029,24,2,22,92,11.7
4032,24,-1,25,276,2.21
4035,26,-8,34,49,1.38
4037,28,-9,37,37,1.38
4038,26,-8,34,52,1.42
4041,26,-8,34,45,1.38
4042,27,-9,36,47,1.69
4043,17,-10,27,92,1.59
4045,31,-1,32,51,3.72
4046,21,-5,26,157,2.85
4048,24,1,23,105,8.17
4049,30,-2,32,51,3.25
4051,25,-13,38,59,4.02
4052,24,1,23,105,7.88
4053,28,-6,34,47,5.05
4054,29,-5,34,44,4.83
4055,29,-5,34,46,3.31
4056,27,-7,34,63,4.33
4057,21,-8,29,111,4.31
4058,20,-10,30,112,4.31
4059,29,-5,34,44,4.83
4060,29,-5,34,44,4.83
4061,28,-6,34,60,4.17
4062,28,-5,33,45,3.62
4063,30,-5,35,45,3.31
4064,27,0,27,75,5.45
4065,27,-6,33,83,3.26
4066,24,1,23,136,8.62
4104,26,-8,34,54,2.04
4105,25,-7,32,56,2.04
4106,26,-8,34,54,2.04
4108,26,-8,34,52,1.66
4110,26,-8,34,51,1.66
4112,26,-8,34,49,1.69
4114,24,1,23,105,7.88
4115,32,-3,35,67,3.14
4116,24,1,23,104,9.28
4118,25,-7,32,59,2.29
4119,24,0,24,130,5.45
4124,27,-1,28,73,3.96
4125,27,1,26,109,7.13
4126,26,-4,30,82,3.52
4129,26,1,25,113,10.41
4133,30,-5,35,91,3.17
4134,31,-3,34,20,8.93
4135,24,2,22,95,13.25
4136,24,2,22,95,13.25
4137,24,1,23,95,13.25
4138,28,1,27,84,3.46
4139,22,-9,31,95,2.4
4140,31,-3,34,22,3.79
4141,24,1,23,105,9.28
4151,22,-4,26,190,5.34
4152,22,-4,26,190,5.34
4153,24,2,22,95,13.25
4154,30,-5,35,23,2.27
4156,23,0,23,114,6.92
4157,26,1,25,113,6.58
4158,27,-3,30,84,3.09
4159,19,-4,23,320,4.88
4160,24,2,22,102,13.25
4167,27,1,26,108,5.39
4178,29,-5,34,50,2.29
4179,24,-9,33,72,1.62
4180,18,-2,20,321,2.21
4181,24,1,23,96,2.95
4182,25,0,25,128,6.46
4183,20,-7,27,76,2.03
4184,21,-7,28,70,2.03
4185,19,-7,26,89,2.03
4186,19,-7,26,87,2.03
4188,25,-6,31,47,2.03
4921,15.77,-4.78,20.55,361,0.75
4923,14.95,-2.9,17.85,355,0.34
4925,15.26,-3.31,18.57,408,0.25
4926,15.8,-3.37,19.17,379,0.76
4928,17.18,-8.67,25.85,199,0.84
4929,15.85,-4.36,20.21,302,0.12
4930,16.13,-4.95,21.08,278,0.75
4931,16.08,-3.88,19.96,295,1.4
4933,15.83,-2.8,18.63,337,0.44
4935,15.76,-3.41,19.17,396,0.54
4938,15.1,-4.29,19.39,330,0.25
4939,15.08,-5.41,20.49,389,0.68
4940,15.66,-4.66,20.32,346,0.44
4941,15.64,-4.65,20.29,386,0.44
4943,15.85,-3.08,18.93,338,0.75
4947,15.85,-4.45,20.3,316,0.75
4954,15.6,-3.78,19.38,688,1.15
4955,15.38,-4.18,19.56,731,0.18
4963,15.68,-3.19,18.87,367,0.75
4965,15.77,-5.28,21.05,314,0.75
4970,15.32,-3.93,19.25,356,0.75
4971,15.1,-4.29,19.39,330,0.75
4975,15.9,-3.54,19.44,319,0.75
4979,16.37,-5.16,21.53,302,0.75
4993,15.2,-8.37,23.57,181,0.75
4995,15.71,-4.8,20.51,310,0.75
4996,15.04,-5.95,20.99,385,0.75
4997,15.75,-3.64,19.39,321,0.75
4999,15.75,-3.65,19.4,325,0.75
5000,15.87,-4.16,20.03,326,0.75
5001,16.94,-2.65,19.59,175,1.52
5004,16.39,-2.56,18.95,178,1.72
5009,18.51,-5.96,24.47,91,0.93
5016,18.6,-5.58,24.18,79,1.05
5022,16.3,-10.05,26.35,149,1.4
5023,18.33,-5.66,23.99,78,1.22
5029,18.33,-5.66,23.99,78,1.33
5036,17.63,-6.51,24.14,88,0.96
5048,16.83,-7.05,23.88,100,0.71
5052,14.86,-5.51,20.37,162,1.22
5053,15.5,-4.39,19.89,157,0.81
5056,16.73,-1.06,17.79,245,2.18
5060,17.09,-3.11,20.2,287,0.75
5061,17.23,-2.33,19.56,265,0.75
5063,18.56,-1.96,20.52,222,0.75
5064,18.34,-2.15,20.49,239,0.75
5065,16.78,-3.07,19.85,340,0.75
5066,15.05,-4.85,19.9,361,0.75
5067,15.64,-4.49,20.13,378,0.75
5068,17.77,-2.2,19.97,223,0.75
5069,17.07,-2.77,19.84,314,0.75
5070,17.87,-2.18,20.05,214,0.75
5071,18.17,-2.14,20.31,218,0.75
5072,17.78,-1.93,19.71,217,0.75
5075,17.88,-2.3,20.18,245,0.75
5076,17.87,-2.32,20.19,247,0.75
5077,17.9,-2.34,20.24,231,0.75
5078,17.29,-3.21,20.5,288,0.75
5079,17.58,-2.27,19.85,226,0.75
5080,17.7,-2.32,20.02,237,0.75
5081,17.65,-2.12,19.77,207,0.75
5082,17.76,-2.02,19.78,227,0.75
5083,17.22,-2.42,19.64,236,0.75
5084,17.62,-2.34,19.96,247,0.75
5085,17.62,-2.34,19.96,247,0.75
5087,17.43,-2.97,20.4,298,0.5
5088,17.44,-2.95,20.39,292,0.99
5091,17.79,-2.26,20.05,230,0.75
5093,17.78,-2.2,19.98,226,0.75
5095,16.68,-0.72,17.4,299,0.84
5097,16.51,-0.86,17.37,300,0.75
5098,16.85,-3.71,20.56,291,0.75
5099,16.94,-3.76,20.7,372,0.75
5100,16.5,-1.48,17.98,172,0.75
5101,16.98,-1.6,18.58,195,0.52
5102,16.98,-1.6,18.58,195,0.75
5103,15.59,-3.44,19.03,357,0.79
5104,14.93,-4.36,19.29,336,0.76
5106,16.84,-2.49,19.33,297,0.5
5107,17.37,-3.14,20.51,155,0.75
5109,16.73,-4.24,20.97,279,0.75
5110,16.73,-4.24,20.97,279,0.75
5113,17.52,-2.51,20.03,252,0.75
5114,17.1,-2.78,19.88,285,0.75
5115,17.1,-2.78,19.88,285,0.75
5116,17.79,-2.26,20.05,368,0.75
5117,17.07,-3.97,21.04,166,0.75
5118,17.07,-3.97,21.04,166,0.75
5119,16.72,-4.31,21.03,187,0.75
5122,17.43,-2.97,20.4,298,0.75
5123,17.43,-2.97,20.4,298,0.75
5126,15.78,-3.49,19.27,392,0.75
5127,15.68,-4.1,19.78,390,1.36
5128,15.71,-4,19.71,390,0.75
5130,15.68,-4.28,19.96,396,0.84
5131,15.69,-4.48,20.17,402,0.81
5132,15.68,-4.29,19.97,400,0.96
5133,15.72,-4.09,19.81,395,0.75
5134,15.66,-4.29,19.95,400,0.75
5136,15.63,-4.2,19.83,400,0.75
5137,17.25,-2.61,19.86,353,0.4
5138,17.43,-2.56,19.99,311,0.48
5139,18.1,-2.96,21.06,308,0.61
5141,18.52,-1.6,20.12,263,0.75
5142,17.38,0.76,16.62,239,0.61
5144,17.38,0.76,16.62,239,0.29
5145,15.59,-0.18,15.77,288,1.68
5146,15.59,-0.18,15.77,288,0.27
5147,15.09,-0.52,15.61,280,0.42
5148,17.57,-3.04,20.61,318,0.26
5149,17.55,-4.38,21.93,388,0.44
5150,17.55,-4.38,21.93,388,0.23
5151,17.55,-4.38,21.93,388,0.37
5153,17.5,-3.58,21.08,308,0.75
5154,17.5,-3.58,21.08,308,0.79
5156,16.85,-4.39,21.24,308,0.75
5157,17.32,-3.75,21.07,309,0.75
5160,15.31,-4.85,20.16,596,0.75
5161,15.31,-4.85,20.16,596,0.75
5162,16.02,-3.93,19.95,589,0.75
5164,16.56,-3.22,19.78,581,0.75
5165,15.19,-4.59,19.78,586,0.75
5167,16.42,-1.7,18.12,306,0.75
5169,16.16,-1.68,17.84,300,0.75
5176,17.09,-1.24,18.33,287,0.75
5178,17.09,-1.24,18.33,287,0.75
5179,16.28,-0.48,16.76,263,0.66
5180,16.41,-0.43,16.84,264,0.9
5182,16.28,-1.09,17.37,274,0.48
5183,16.28,-1.09,17.37,274,0.75
5188,16.14,-4.73,20.87,261,0.75
5189,17.2,-3.86,21.06,189,0.66
5190,16.68,-4.52,21.2,223,0.76
5191,17.04,-3.92,20.96,170,0.57
5192,17.23,-3.71,20.94,164,0.81
5193,17.21,-4.48,21.69,169,0.34
5196,17.44,-2.95,20.39,292,0.75
5197,17.2,-2.28,19.48,259,0.17
5198,17.37,-2.69,20.06,252,0.35
5199,17.5,-2.24,19.74,257,0.35
5200,17.5,-2.24,19.74,257,0.34
5201,15.22,-5.45,20.67,405,0.44
5202,17.92,-0.9,18.82,177,0.75
5204,15.84,-3.89,19.73,339,0.19
5205,18.18,-0.69,18.87,343,0.48
5206,17.53,-1.32,18.85,198,0.75
5207,17.62,-1,18.62,195,0.75
5208,16.74,-1.03,17.77,225,0.18
5209,16.74,-1.03,17.77,225,0.75
5210,18.18,-0.49,18.67,280,0.08
5211,17.7,-2.18,19.88,277,0.75
5212,17.87,-0.06,17.93,290,0.12
5213,18.22,-0.23,18.45,296,0.16
5214,17.84,-0.56,18.4,279,0.75
5215,18.19,-0.13,18.32,269,0.27
5216,16.67,-1,17.67,312,0.75
5217,16.67,-1,17.67,312,0.75
5219,14.61,-4.36,18.97,374,0.75
5221,15.64,-4.49,20.13,378,0.14
5222,17.4,-4.09,21.49,206,0.75
5223,17.7,-3.24,20.94,173,0.21
5224,17.24,-3.78,21.02,190,0.22
5225,17.7,-3.24,20.94,173,0.75
5227,16.59,-3.68,20.27,179,0.75
5229,16.66,-3.69,20.35,179,0.75
5230,16.53,-3.74,20.27,354,0.75
5231,16.53,-3.74,20.27,354,0.75
5233,17.38,-1.93,19.31,216,0.75
5234,17.59,-1.64,19.23,206,0.75
5235,17.59,-1.64,19.23,206,0.27
5236,16.82,-3.02,19.84,267,0.75
5237,16.82,-3.02,19.84,267,0.75
5238,17.27,-2.76,20.03,268,0.75
5239,14.3,-6.81,21.11,371,0.75
5240,14.3,-6.81,21.11,371,0.75
5241,14.3,-6.81,21.11,371,0.75
5244,18.81,-2.1,20.91,253,0.75
5245,16.79,-1.97,18.76,301,0.75
5246,17.07,-1.64,18.71,316,0.75
5247,17.07,-1.64,18.71,316,0.75
5248,16.96,-0.77,17.73,292,0.75
5249,18.42,-1.5,19.92,276,0.21
5251,13.08,-7.1,20.18,505,0.75
5252,16.83,-3.41,20.24,312,0.22
5253,17.87,-2,19.87,226,0.75
5254,17.54,-3.06,20.6,316,0.75
5255,18.68,-3.68,22.36,236,0.75
5256,18.68,-3.68,22.36,236,0.75
5258,18.73,-2.28,21.01,244,0.75
5259,18.66,-3.28,21.94,261,0.75
5260,17.77,-4.25,22.02,255,0.75
5261,18.94,-3.21,22.15,234,0.75
5262,18.94,-3.21,22.15,234,0.75
5263,16.1,-1.24,17.34,149,0.52
5264,16.08,-1.23,17.31,149,0.75
5265,16.08,-1.23,17.31,149,0.75
5266,16.75,-5.04,21.79,263,0.75
5267,16.75,-5.04,21.79,263,0.75
5270,12.44,-8.48,20.92,476,0.75
5272,18.75,-3.6,22.35,237,0.75
5274,16.95,-2.51,19.46,199,0.75
5276,16.95,-2.51,19.46,199,0.75
5278,17.49,-1.98,19.47,245,0.29
5279,17.49,-1.98,19.47,245,0.75
5283,17.12,-1.13,18.25,198,0.75
5284,17.11,-2.42,19.53,272,0.75
5285,17.83,-2.06,19.89,237,0.75
5286,18.37,-1.56,19.93,208,0.75
5287,18.09,-2.4,20.49,221,0.17
5288,18.09,-2.4,20.49,221,0.75
5289,18.09,-2.4,20.49,221,0.75
5294,15.71,-4.24,19.95,394,0.75
5295,15.55,-4.38,19.93,404,0.12
5296,15.63,-4.2,19.83,400,0.15
5297,15.55,-4.32,19.87,406,0.17
5298,15.06,-4.68,19.74,443,0.14
5299,15.55,-4.4,19.95,407,0.17
5302,15.68,-4.1,19.78,390,0.75
5303,15.69,-4.11,19.8,391,0.75
5304,15.62,-4.19,19.81,401,0.75
5308,16.82,-1.13,17.95,291,0.27
5309,15.46,-2.67,18.13,325,0.26
5310,16.33,-4.55,20.88,223,0.25
5311,15.64,-4.09,19.73,400,0.75
5312,17.05,-1.48,18.53,210,0.75
5319,17.37,-2.28,19.65,279,0.75
5321,15.66,-4.2,19.86,393,0.75
5322,14.95,-5.71,20.66,347,0.75
5338,12.44,-8.48,20.92,476,0.75
5370,16.99,-0.34,17.33,225,0.75
5376,16.99,-1.45,18.44,236,0.75
5390,15.92,-2.56,18.48,344,0.75
5406,17.45,-1.71,19.16,237,0.75
5410,15.92,-2.56,18.48,344,0.75
5417,17.04,-1.15,18.19,282,0.75
5441,16.63,-1.6,18.23,225,0.75
5459,16.77,-1.17,17.94,231,0.75
5524,17.65,-1.11,18.76,208,0.75
5525,17.53,-1.22,18.75,209,0.75
5527,17.61,-0.99,18.6,211,0.75
5535,18.87,-2.08,20.95,332,0.75
5536,18.32,-0.44,18.76,286,0.75
5537,18.85,-1.3,20.15,274,0.75
5538,17.08,-3.78,20.86,176,0.75
5539,17.25,-2.83,20.08,185,0.75
5540,17.35,-4.75,22.1,364,0.75
5541,17.23,-3.36,20.59,192,0.75
5542,18,0.19,17.81,190,0.75
5543,17.88,-0.1,17.98,299,0.75
5544,18.52,-1.55,20.07,241,0.75
5545,17.15,-3.24,20.39,178,0.75
5546,18.31,-2.96,21.27,275,0.75
5547,17.87,-3.78,21.65,294,0.75
5548,16.92,-1.28,18.2,234,0.75
5549,17.81,-2.02,19.83,229,0.75
5550,16.84,-1.53,18.37,181,0.75
5551,16.42,-0.78,17.2,359,0.75
5552,16.99,-0.38,17.37,362,0.75
5553,16.96,-0.29,17.25,320,0.75
5554,16.36,-0.58,16.94,325,0.75
5556,18.06,0.29,17.77,267,0.75
5557,18.08,0.7,17.38,231,0.75
5558,17.13,0.79,16.34,238,0.75
5559,17.16,0.47,16.69,242,0.75
5560,17.14,0.45,16.69,246,0.75
5561,17.21,0.27,16.94,246,0.75
5562,17.35,0,17.35,255,0.75
5563,18.41,-1.13,19.54,209,0.75
5564,17.86,-1.09,18.95,248,0.75
5565,17.1,-1.44,18.54,213,0.75
5566,15.05,0.08,14.97,280,0.75
5567,15.42,0.43,14.99,264,0.75
5568,14.46,-0.36,14.82,264,0.75
5569,15.02,-0.04,15.06,243,0.75
5570,14.26,-0.15,14.41,264,0.75
5571,15.59,-0.18,15.77,288,0.75
5572,15.09,-0.52,15.61,280,0.75
5573,14.8,0.07,14.73,254,0.75
5574,14.08,-0.65,14.73,310,0.75
5575,17.44,-1.16,18.6,214,0.75
5576,16.51,-0.87,17.38,305,0.48
5577,16.51,-0.87,17.38,305,0.5
5579,16.55,-1.72,18.27,334,0.75
5581,16.55,-1.72,18.27,334,0.75
5582,18.44,-4.8,23.24,297,0.75
5585,19.36,-4.77,24.13,263,0.75
5587,19.31,-4.88,24.19,251,0.75
5589,17.78,-1.94,19.72,218,0.75
5591,18.27,-2.08,20.35,213,0.75
5592,15.51,-5.7,21.21,392,0.46
5593,15.51,-5.7,21.21,392,0.4
5595,15.42,-2.01,17.43,386,0.75
5597,15.68,-1.67,17.35,393,0.75
5598,16.25,-1.11,17.36,299,1.19
5599,16.25,-1.11,17.36,299,0.75
5601,13.52,-7.46,20.98,458,0.54
5603,16.54,-2.64,19.18,244,0.75
5605,16.73,-4.27,21,346,0.75
5607,17.82,-6.38,24.2,169,0.75
5608,16.35,-5.99,22.34,180,1.33
5609,16.16,-6.21,22.37,191,1.22
5610,13.37,-1.65,15.02,311,0.68
5616,14.26,-0.15,14.41,264,0.75
5617,14.79,-0.07,14.86,267,0.59
5619,17.38,-0.26,17.64,275,0.75
5621,17.38,-0.26,17.64,275,0.75
5622,14.88,0.15,14.73,254,0.75
5625,17.14,0.78,16.36,237,0.75
5626,16.8,0.4,16.4,247,0.75
5627,18.64,-1.92,20.56,235,0.75
5630,15.75,-3.37,19.12,389,0.75
5631,17.76,-1.84,19.6,215,0.75
5633,17.44,-1.16,18.6,237,0.75
5636,17.87,-0.06,17.93,290,0.75
5643,17.3,-0.04,17.34,258,0.75
5649,17.41,-7.77,25.18,112,0.75
5650,18.12,-3.57,21.69,351,0.42
5651,18,-1.92,19.92,305,0.57
5652,17.45,-5.06,22.51,353,1.95
5655,17.02,0.21,16.81,237,1.95
5656,18.14,-5.2,23.34,188,0.29
5657,17.57,0.06,17.51,234,1.29
5659,16.45,-0.17,16.62,350,0.59
5660,16.97,0.25,16.72,242,0.99
5662,14.52,-13.86,28.38,173,0.75
5665,14.2,-11.3,25.5,174,0.75
5669,17.19,-6.32,23.51,190,0.75
5670,16.55,-0.66,17.21,245,0.75
5674,17.99,-0.81,18.8,172,0.75
5675,18.38,-1.29,19.67,220,0.75
5676,16.94,-3.2,20.14,266,0.75
5677,16.8,-3.03,19.83,237,0.75
5678,11.78,-10.01,21.79,454,0.75
5681,18.96,-1.78,20.74,256,0.75
5685,12.81,-9.05,21.86,423,0.75
5689,15.38,-3.73,19.11,318,0.75
100026,25,-8,33,114,12.58
100031,25,-7,32,113,12.71
100032,25,-7,32,114,13.31
100033,25,-7,32,115,12.85
100035,24,-7,31,115,12.7
100036,25,-7,32,113,13.85
100037,25,-7,32,114,13.85
100039,24,-8,32,120,12.8
100042,24,-8,32,118,12.83
100044,24,-8,32,117,12.83
100045,24,-8,32,116,12.69
100047,25,-8,33,115,13.06
100048,25,-8,33,115,13.12
100049,25,-8,33,114,13.06
100050,24,-8,32,114,12.72
100052,24,-8,32,115,13.27
100054,25,-7,32,114,13.42
100057,32,7,25,131,10.21
100059,33,5,28,129,8.85
100060,33,5,28,129,8.85
100061,32,5,27,139,8.56
100062,32,5,27,139,8.56
100063,33,5,28,132,8.75
100064,33,5,28,132,8.75
100065,32,4,28,138,8.83
100066,32,4,28,138,8.83
100067,32,4,28,137,8.62
100068,32,5,27,137,9.11
100069,33,4,29,141,8.93
100070,33,4,29,141,8.93
100072,32,5,27,169,10.77
100074,33,3,30,166,10.3
100076,32,5,27,126,8.59
100077,33,5,28,126,8.75
100080,31,5,26,129,10.8
100083,33,4,29,128,9.01
100085,33,4,29,127,8.84
100086,33,4,29,127,8.84
100087,33,4,29,128,9.68
100088,32,4,28,126,9.59
100089,32,4,28,121,9.26
100090,32,4,28,121,9.26
100091,33,4,29,129,8.91
100092,33,4,29,129,8.55
100093,33,4,29,129,8.55
100094,32,4,28,126,8.64
100095,32,4,28,126,8.64
100096,32,4,28,122,8.83
100097,32,4,28,122,8.83
100098,32,4,28,129,9.24
100099,32,4,28,129,9.24
100100,32,4,28,125,9.01
100101,32,4,28,125,9.01
100102,33,4,29,119,9.28
100104,33,4,29,119,9.28
100105,32,4,28,134,8.47
100107,32,4,28,134,8.47
100108,32,3,29,134,8.39
100109,32,3,29,128,8.43
100110,32,3,29,128,8.43
100111,32,3,29,147,10
100112,32,3,29,147,10
100114,32,3,29,139,8.56
100116,32,3,29,139,8.56
100117,32,3,29,136,8.9
100119,32,3,29,153,9.39
100120,32,2,30,158,8.8
100121,32,3,29,147,9.24
100122,32,3,29,147,9.24
100123,33,2,31,147,9.11
100125,32,3,29,143,9.77
100127,32,3,29,143,9.77
100128,33,3,30,167,9.22
100130,32,3,29,167,10.34
100134,32,3,29,163,8.84
100135,33,2,31,154,8.6
100136,32,3,29,155,8.7
100138,32,3,29,150,8.81
100140,33,2,31,145,9.37
100141,33,3,30,163,9.94
100143,33,3,30,147,8.64
100144,28,-3,31,50,3.16
100148,30,-1,31,42,3.89
100154,29,0,29,53,3.86
100163,32,4,28,128,11.35
100164,32,4,28,123,9.37
100166,32,3,29,119,9.22
100167,32,3,29,119,9.22
100168,32,3,29,117,8.91
100169,32,2,30,118,9.19
100170,32,2,30,119,9.14
100171,33,3,30,120,8.75
100172,33,3,30,119,10.81
100173,33,2,31,120,9.57
100175,33,2,31,120,9.57
100176,33,2,31,118,9.65
100177,33,3,30,117,11.5
100178,33,3,30,117,11.5
100179,32,2,30,122,9.77
100180,32,2,30,122,9.77
100181,32,2,30,118,10.5
100182,32,3,29,121,9.43
100183,32,3,29,121,9.43
100184,32,3,29,127,9.21
100186,32,3,29,127,9.21
100187,32,1,31,127,10.31
100188,31,1,30,129,10.38
100189,32,3,29,139,8.74
100190,32,3,29,139,8.74
100191,32,2,30,132,8.31
100192,32,2,30,132,8.31
100193,32,2,30,138,9.08
100194,32,2,30,131,8.53
100195,32,2,30,138,9.64
100197,32,2,30,138,9.64
100198,32,1,31,133,9.93
100199,32,1,31,138,9.96
100200,32,1,31,140,9.97
100201,32,1,31,140,9.78
100202,32,1,31,140,9.78
100203,32,2,30,144,8.73
100204,32,2,30,140,8.82
100205,32,2,30,138,9.69
100206,32,1,31,147,10.1
100208,32,1,31,147,10.1
100209,31,1,30,145,9.82
100212,32,2,30,139,9.89
100213,32,1,31,142,10.78
100214,32,1,31,142,10.78
100215,32,2,30,143,9.6
100216,32,1,31,141,9.91
100217,32,1,31,141,9.91
100224,23,-7,30,58,3.81
100225,24,-7,31,58,3.46
100226,20,-8,28,77,4.83
100228,29,-4,33,44,2.77
100230,28,-5,33,44,3.43
100231,32,-5,37,39,2.81
100237,22,-4,26,83,4.09
100238,26,-3,29,63,4.52
100244,26,-3,29,73,4.05
100246,27,-1,28,73,7.31
100247,26,-3,29,55,5.48
100250,31,1,30,54,3.68
100252,31,2,29,132,9.13
100253,32,1,31,126,9.79
100254,32,3,29,124,9.75
100256,32,3,29,125,10.3
100257,32,2,30,121,10.71
100258,32,1,31,121,10.86
100259,32,2,30,121,9.99
100260,32,1,31,123,10.51
100262,32,2,30,118,9.05
100264,32,1,31,120,9.27
100265,32,1,31,121,13.55
100266,32,1,31,120,9.67
100267,32,0,32,120,9.86
100268,32,2,30,120,11.09
100269,32,1,31,120,10.32
100270,32,2,30,123,11.38
100271,32,2,30,123,11.38
100272,32,1,31,121,10.55
100274,32,1,31,121,11.31
100275,31,1,30,124,10.52
100276,31,1,30,124,10.52
100277,31,1,30,130,13.08
100278,31,1,30,130,13.08
100279,31,1,30,126,15.58
100280,31,1,30,134,10.06
100282,31,1,30,134,10.06
100283,31,1,30,127,14.97
100285,31,1,30,132,13.35
100286,30,0,30,137,14.15
100287,31,0,31,138,15.83
100289,30,0,30,137,20.28
100290,31,0,31,140,10.71
100291,30,0,30,149,12.26
100293,30,0,30,149,12.26
100294,31,0,31,139,11.75
100295,31,0,31,139,11.75
100296,30,0,30,140,12.98
100297,30,0,30,140,12.98
100298,30,0,30,139,12.77
100300,30,0,30,139,12.77
100301,31,0,31,144,10.54
100304,32,1,31,140,11.64
100305,32,1,31,144,14.35
100306,32,1,31,144,14.35
100307,31,0,31,143,12.17
100308,31,0,31,143,12.17
100309,31,0,31,148,12.65
100310,30,-1,31,145,12.25
100312,32,1,31,143,9.75
100313,32,1,31,147,11.65
100314,32,-1,33,152,10.89
100316,32,-1,33,152,10.89
100317,32,-1,33,151,11.2
100318,32,-1,33,151,11.2
100319,32,1,31,142,10.42
100320,32,0,32,149,10.61
100321,32,0,32,149,10.61
100324,25,-7,32,55,3.65
100325,22,-7,29,74,4.26
100326,25,-8,33,65,4.15
100327,27,-6,33,44,3.51
100329,21,-8,29,55,3.48
100330,26,-9,35,38,2.76
100331,24,-6,30,44,2.49
100332,26,-5,31,58,3.64
100334,25,-9,34,48,3.15
100335,26,-9,35,44,2.84
100336,26,-10,36,53,3.54
100337,23,-7,30,57,3.31
100339,27,-11,38,38,2.69
100340,24,-10,34,52,3.01
100344,28,-6,34,53,4.1
100345,26,-6,32,58,4.27
100346,24,-6,30,62,3.59
100347,27,-6,33,60,3.88
100348,26,-8,34,63,3.89
100349,27,-7,34,54,3.76
100350,24,-10,34,68,3.9
100353,26,-9,35,74,5.02
100356,25,-9,34,73,4.26
100357,27,-7,34,59,3.92
100358,27,-5,32,57,4.47
100360,29,-6,35,53,3.67
100361,29,-7,36,62,4.46
100363,31,-6,37,54,4.18
100365,31,-5,36,50,3.24
100366,30,-4,34,53,3.69
100367,31,-5,36,51,3.39
100371,30,-5,35,69,5.23
100372,29,-1,30,65,13.86
100373,30,3,27,149,9.04
100375,31,1,30,137,16.27
100377,31,1,30,137,12.2
100378,31,1,30,125,11.75
100379,32,1,31,127,10.05
100380,31,1,30,122,10.46
100381,31,1,30,121,10.31
100382,31,0,31,123,11.62
100383,31,1,30,119,11.15
100384,31,1,30,121,10.18
100385,31,1,30,121,10.8
100387,31,0,31,120,11.86
100388,32,0,32,120,10.39
100390,32,0,32,122,11.06
100391,31,-1,32,122,10.86
100392,31,0,31,119,10.62
100393,31,0,31,124,12.19
100394,31,0,31,126,11.13
100395,31,0,31,126,11.13
100396,31,0,31,126,10.98
100397,31,0,31,140,13.41
100398,30,0,30,162,11.54
100399,30,0,30,145,14.97
100400,31,1,30,133,14.26
100402,30,0,30,150,15.94
100403,29,-1,30,166,13.56
100404,29,-1,30,166,13.56
100405,27,-2,29,191,12.85
100406,27,-3,30,182,14.58
100407,29,-2,31,181,13.57
100408,30,0,30,140,18.13
100409,30,0,30,140,18.13
100411,30,0,30,142,15.3
100412,29,0,29,152,14.83
100414,29,0,29,152,14.83
100415,29,0,29,152,14.25
100416,27,-4,31,192,15.09
100417,27,-4,31,192,15.09
100418,31,0,31,138,12.62
100419,32,0,32,143,11
100420,31,0,31,132,13.05
100421,31,-1,32,141,13.03
100422,28,-1,29,167,13.45
100423,30,-1,31,153,11.97
100424,31,-1,32,148,13.76
100425,31,-1,32,154,11.07
100426,31,0,31,154,12.57
100427,31,0,31,154,12.57
100428,32,0,32,143,13.83
100430,31,-1,32,149,11.32
100431,28,-7,35,41,2.71
100432,26,-8,34,54,4.63
100433,25,-7,32,42,2.71
100434,26,-10,36,35,2.63
100435,25,-9,34,37,2.97
100436,24,-8,32,47,2.82
100437,26,-10,36,32,2.45
100438,26,-10,36,33,2.53
100439,26,-10,36,39,2.62
100440,27,-10,37,37,2.59
100442,23,-10,33,89,4.87
100443,24,-9,33,80,4.94
100450,27,-5,32,90,5.99
100452,28,-8,36,44,3.44
100453,27,-8,35,48,4.26
100456,25,-9,34,67,5.68
100460,29,-7,36,35,3.06
100462,30,-5,35,79,5.73
100463,30,-6,36,78,5.5
100467,27,-4,31,71,6.78
100468,26,-9,35,54,5.09
100470,25,-9,34,69,5.7
100471,26,-9,35,67,6.16
100472,33,-2,35,44,4.78
100473,27,-8,35,52,4.38
100474,33,-2,35,42,4.78
100476,25,-10,35,69,5.37
100480,27,-5,32,61,4.89
100488,24,-5,29,79,12.85
100494,33,4,29,61,7
100495,29,-6,35,65,6.16
100498,33,-3,36,33,5.74
100499,32,-3,35,35,5.58
100500,26,7,19,53,6.56
100501,31,2,29,133,10.13
100503,30,1,29,126,11.83
100504,31,2,29,133,12.02
100506,31,1,30,127,12.66
100507,31,0,31,121,16.91
100508,31,0,31,119,12.38
100509,31,0,31,120,13.86
100511,30,-1,31,118,13.24
100512,30,-1,31,115,13.31
100513,31,0,31,121,11.63
100514,31,0,31,122,11.57
100515,31,0,31,121,11.61
100516,30,-1,31,120,12.42
100517,30,-1,31,117,14
100518,30,-1,31,120,12.26
100519,30,-1,31,119,13.76
100520,30,-1,31,125,12.58
100521,29,-2,31,126,11.71
100522,30,-2,32,134,11.77
100523,30,-1,31,124,12.99
100524,30,0,30,142,12.26
100525,30,0,30,150,11.41
100526,26,-3,29,135,12.39
100527,27,-4,31,148,11.69
100528,22,-5,27,184,13.07
100529,25,-6,31,117,9.66
100530,29,-2,31,102,9.23
100531,26,-4,30,123,11.16
100532,27,-3,30,104,9.85
100533,25,-3,28,180,11.64
100534,26,-5,31,194,11.54
100535,25,-3,28,192,9.78
100536,26,-4,30,136,11.21
100537,29,-2,31,158,11.97
100538,30,-1,31,154,13.12
100539,31,-2,33,144,13.07
100540,29,-3,32,149,13.21
100542,28,-1,29,159,12.53
100543,28,-8,36,43,4.26
100545,26,-9,35,48,4.4
100546,23,-11,34,59,4.45
100547,28,-7,35,46,3.29
100548,24,-8,32,53,4.24
100550,28,-9,37,27,2.44
100552,28,-9,37,34,2.91
100553,27,-9,36,35,2.93
100554,28,-9,37,33,2.75
100555,27,-9,36,30,2.98
100556,27,-9,36,33,3.01
100557,27,-9,36,35,3.04
100558,27,-9,36,30,2.67
100560,24,-10,34,50,2.76
100561,30,-9,39,31,2.85
100563,28,-8,36,33,3.27
100566,26,-10,36,37,3.44
100567,27,-9,36,33,3.78
100569,27,-9,36,34,3.34
100571,27,-8,35,34,3.54
100572,28,-7,35,30,3.25
100574,30,-7,37,28,2.87
100575,26,-9,35,55,4.78
100576,26,-10,36,65,5.52
100577,28,-8,36,45,4.55
100579,23,-10,33,75,5.25
100582,26,-10,36,51,4.77
100583,28,-9,37,35,4.19
100586,26,-8,34,43,3.3
100587,28,-8,36,65,5.05
100588,28,-7,35,58,4.77
100593,31,-5,36,34,3.55
100602,30,-7,37,51,4
100605,30,-6,36,45,3.93
100609,29,-6,35,42,4.01
100611,28,-5,33,42,4.73
100614,33,1,32,29,9.71
100615,28,-1,29,31,7.45
100616,30,0,30,34,7.26
100617,30,-1,31,69,7.53
100618,33,1,32,35,7.52
100620,34,0,34,29,4.22
100621,24,-4,28,88,6.92
100624,26,-3,29,88,5.82
100625,30,4,26,72,6.2
100626,34,0,34,26,4.95
100627,34,0,34,43,5.41
100628,33,3,30,49,4.02
100629,30,2,28,125,13.22
100630,31,-1,32,121,13.04
100631,30,0,30,123,13.5
100633,30,0,30,123,13.5
100634,31,0,31,120,12.59
100635,30,-1,31,117,12.69
100636,31,0,31,117,12.29
100637,30,-1,31,122,12.7
100638,30,-2,32,116,12.76
100640,30,-1,31,118,11.9
100641,30,-2,32,113,13.73
100643,30,-2,32,113,13.73
100644,30,-2,32,114,12.32
100646,30,-2,32,115,12.14
100649,30,-3,33,116,11.76
100650,30,-1,31,116,13.29
100651,30,-2,32,116,12.11
100652,30,-2,32,116,12.11
100653,29,-3,32,129,12.92
100655,29,-2,31,122,12.3
100656,29,-2,31,126,11.48
100657,29,-2,31,126,11.48
100658,29,-3,32,122,12.45
100659,30,-3,33,133,11.42
100660,29,-2,31,128,10.57
100661,28,-4,32,114,10.49
100663,25,-5,30,119,10.13
100665,25,-5,30,119,10.13
100666,27,-5,32,116,10.54
100667,29,-4,33,134,10.91
100668,29,-4,33,134,10.91
100669,28,-4,32,121,11.8
100672,28,-5,33,141,13.22
100673,27,-9,36,45,3.51
100674,23,-11,34,60,3.8
100675,28,-9,37,32,2.67
100676,20,-11,31,71,4.86
100677,21,-12,33,57,4.02
100678,24,-11,35,47,2.91
100679,26,-13,39,43,3.65
100680,26,-13,39,44,3.33
100681,18,-14,32,103,5.15
100683,27,-14,41,47,3.62
100684,28,-11,39,33,3.34
100685,28,-12,40,36,3.39
100687,27,-13,40,46,3.36
100688,29,-11,40,31,4.12
100689,29,-9,38,32,3.81
100696,24,-10,34,52,4.03
100698,30,-8,38,24,2.6
100711,25,-8,33,61,6.45
100713,28,-6,34,47,5.6
100729,27,-5,32,43,5.22
100730,25,-7,32,39,3.64
100734,25,-7,32,52,3.61
100735,27,0,27,92,6.26
100739,23,-7,30,88,3.25
100740,31,3,28,80,4.72
100742,26,-4,30,94,2.94
100743,25,-4,29,92,5.25
100745,35,3,32,58,6.32
100746,31,1,30,79,4.56
100747,34,-1,35,44,4.65
100748,33,-1,34,41,4.26
100749,28,3,25,62,4.09
100750,27,3,24,43,5.97
100751,29,5,24,89,7.91
100752,30,0,30,118,12.54
100753,30,0,30,118,12.54
100754,30,0,30,118,12.93
100755,30,0,30,118,12.93
100756,30,-1,31,116,12.77
100758,30,-1,31,116,12.77
100761,30,-2,32,115,13.09
100762,31,0,31,114,14.34
100763,31,0,31,114,14.34
100764,30,-1,31,113,16.96
100765,30,-1,31,113,16.96
100766,30,-2,32,113,12.7
100767,30,-3,33,109,12.66
100768,30,-3,33,109,12.66
100769,30,-2,32,112,13.49
100770,30,-2,32,112,13.49
100771,29,-3,32,111,13.6
100772,30,-3,33,111,12.36
100774,30,-3,33,111,12.36
100775,30,-3,33,114,12.33
100777,30,-3,33,115,12.28
100779,30,-3,33,115,12.28
100780,30,-3,33,110,11.46
100781,29,-3,32,123,11.19
100782,29,-3,32,123,11.19
100783,30,-3,33,111,11.6
100784,30,-3,33,111,11.6
100785,30,-3,33,114,11.37
100786,29,-2,31,112,11.78
100787,29,-2,31,112,11.78
100789,29,-2,31,111,13.66
100790,28,-2,30,117,12.03
100791,28,-2,30,117,12.03
100792,29,-3,32,118,11.25
100793,29,-3,32,118,10.91
100794,28,-3,31,117,9.94
100796,28,-4,32,110,9.35
100798,28,-4,32,110,9.35
100799,28,-5,33,113,9.52
100800,26,-4,30,117,12.28
100801,27,-3,30,114,10.49
100802,27,-3,30,114,10.49
100803,28,-4,32,104,11.26
100804,28,-4,32,104,11.26
100805,27,-4,31,112,12.88
100806,26,-4,30,100,10.22
100807,27,-4,31,98,9.08
100808,27,-4,31,96,12.88
100809,26,-5,31,104,11.72
100810,26,-5,31,104,11.72
100811,27,-4,31,108,11.26
100812,26,-4,30,113,11.24
100813,25,-5,30,105,10.02
100814,26,-5,31,107,9.88
100815,26,-5,31,107,9.88
100816,27,-4,31,100,11.12
100817,27,-4,31,100,11.12
100818,27,-4,31,118,11.95
100819,26,-4,30,98,11.87
100820,27,-4,31,111,11.56
100821,26,-4,30,119,12.13
100822,26,-4,30,119,12.13
100823,27,-4,31,116,11.54
100824,27,-4,31,113,12
100825,25,-4,29,119,11.99
100826,27,-4,31,120,12.2
100827,26,-4,30,101,12.2
100828,27,-4,31,127,12.79
100829,28,-4,32,119,11.97
100830,28,-4,32,124,12.37
100831,27,-4,31,113,12.32
100832,26,-4,30,117,12.04
100833,25,-4,29,102,9.85
100834,27,-4,31,116,13.06
100835,26,-4,30,129,13.05
100836,28,-4,32,116,12.62
100837,28,-4,32,120,12.31
100838,28,-4,32,121,12.63
100839,30,-3,33,119,14.35
100840,30,-2,32,119,13.43
100841,30,-3,33,115,11.73
100847,28,-8,36,42,4.4
100849,30,-8,38,38,3.88
100852,30,-9,39,39,4.52
100856,24,-9,33,51,5.07
100858,26,-9,35,49,4.1
100859,25,-9,34,49,4.4
100861,27,-9,36,44,4.32
100863,26,-9,35,50,4.05
100864,26,-9,35,50,3.87
100865,27,-9,36,45,4.13
100866,30,-9,39,37,3.78
100871,19,-13,32,57,4.47
100872,23,-10,33,43,3.49
100875,23,-10,33,37,3.2
100876,20,-12,32,55,3.99
100877,18,-15,33,99,4.8
100879,26,-13,39,52,3.74
100881,19,-14,33,70,3.47
100885,22,-17,39,46,3.55
100892,19,-15,34,99,3.25
100893,17,-16,33,107,3.86
100894,28,-12,40,40,3.33
100900,26,-12,38,64,4.58
100903,19,-12,31,81,4.3
100904,19,-12,31,86,5.17
100906,22,-11,33,72,4.77
100907,17,-14,31,113,5.11
100908,21,-14,35,78,4.64
100909,20,-15,35,80,5.09
100914,19,-16,35,90,4.36
100917,18,-14,32,95,3.77
100919,27,-8,35,53,3.92
100922,28,-8,36,40,3.88
100925,26,-11,37,53,4.7
100926,22,-13,35,68,4.4
100927,24,-9,33,58,4.38
100929,30,-8,38,34,3.68
100933,19,-15,34,86,4.32
100936,28,-11,39,33,3.41
100938,25,-12,37,57,4.07
100942,29,-8,37,24,2.77
100949,31,-6,37,29,3.65
100952,26,-9,35,52,5.23
100955,24,-8,32,44,3.95
100970,26,-10,36,35,3.26
100972,27,-10,37,34,3.17
100973,21,-13,34,56,3.23
100982,28,-6,34,44,2.93
100983,29,-8,37,38,2.8
100989,26,-9,35,45,4.02
100994,25,-12,37,42,3.47
101005,24,-9,33,56,4.59
101011,22,-9,31,53,4.27
101020,27,-6,33,42,3.78
101039,32,2,30,69,5.53
101042,34,1,33,53,5.65
101043,34,1,33,74,5.22
101044,24,-4,28,106,3.15
101048,28,-1,29,109,4.46
101050,22,-6,28,122,3.28
101052,25,-3,28,119,5.03
101054,33,1,32,75,5.59
101055,32,0,32,90,5.76
101056,31,0,31,99,5.44
101057,27,-2,29,108,5.57
101058,34,2,32,53,7.22
101059,26,6,20,126,10.13
101060,31,4,27,50,5.63
101061,27,4,23,62,8.4
101063,30,-1,31,113,13.38
101064,29,-1,30,116,14.73
101065,29,-1,30,114,16.06
101066,30,-1,31,111,13.87
101067,29,-1,30,114,15.57
101068,29,-1,30,114,15.6
101069,30,-1,31,112,14.26
101070,30,-2,32,112,14.22
101071,30,-1,31,112,15.11
101072,30,-1,31,112,15.11
101075,29,-1,30,113,13.67
101077,29,-1,30,113,17.56
101078,29,-2,31,112,17.92
101080,30,-2,32,112,13.22
101081,30,-2,32,112,13.22
101082,30,-3,33,110,12.87
101083,30,-3,33,110,12.87
101084,29,-1,30,110,7.82
101085,30,-3,33,111,12.43
101087,28,-4,32,118,12.19
101088,28,-4,32,118,12.19
101089,28,-5,33,110,14.3
101091,28,-5,33,110,14.3
101092,25,-5,30,136,15.66
101093,28,-5,33,108,13.18
101094,28,-5,33,108,13.18
101095,27,-5,32,122,14.96
101096,29,-4,33,96,12
101097,29,-4,33,96,12
101098,27,-5,32,107,13.51
101099,28,-5,33,107,9.85
101100,28,-5,33,107,9.85
101101,26,-7,33,113,9.17
101102,23,-8,31,117,12.09
101103,23,-8,31,117,12.09
101104,28,-5,33,99,10.79
101105,22,-9,31,130,11.94
101106,25,-6,31,109,10.31
101107,25,-6,31,109,10.27
101108,25,-7,32,110,9.69
101109,26,-6,32,107,10.37
101110,23,-8,31,135,14.48
101111,24,-7,31,137,12.98
101112,25,-7,32,103,11.74
101113,29,-5,34,92,10.43
101114,23,-8,31,142,15.23
101115,26,-6,32,111,9.66
101116,24,-6,30,147,13.23
101117,26,-5,31,125,14.21
101118,23,-7,30,141,12.97
101119,27,-4,31,119,12.46
101120,26,-7,33,116,9.29
101121,22,-8,30,143,14.5
101122,26,-6,32,140,14.14
101123,25,-7,32,126,10.53
101124,26,-5,31,139,13.2
101125,27,-5,32,133,13.64
101126,25,-7,32,136,12.87
101127,26,-5,31,147,14.06
101128,24,-7,31,163,14.8
101129,28,-4,32,126,12.64
101130,25,-6,31,147,15.22
101131,25,-6,31,147,15.52
101132,27,-5,32,128,13.26
101133,28,-5,33,127,13.38
101134,28,-5,33,116,12.47
101135,27,-4,31,119,13.06
101136,28,-4,32,122,12.82
101137,28,-3,31,117,12.48
101138,28,-4,32,115,12.92
101139,28,-4,32,120,12.55
101140,28,-4,32,117,12.48
101141,29,-3,32,112,12.61
101142,28,-4,32,122,12.44
101143,28,-4,32,120,14.84
101144,29,-3,32,112,15.53
101145,29,-3,32,106,13.7
101146,28,-4,32,122,12.64
101147,29,-4,33,115,13.67
101148,29,-4,33,108,13.58
101149,28,-4,32,119,12.51
101150,29,-4,33,113,13.28
101151,29,-5,34,114,12.37
101152,28,-4,32,121,12.81
101153,29,-4,33,115,13.2
101154,29,-4,33,113,13.81
101155,28,-4,32,119,13.64
101156,29,-4,33,104,12.78
101157,28,-4,32,117,11.89
101158,28,-3,31,117,13.16
101159,29,-4,33,116,12.24
101160,29,-3,32,115,12.89
101161,29,-3,32,113,12.41
101162,29,-4,33,111,13.4
101163,29,-3,32,108,12.86
101164,29,-4,33,107,14.08
101165,29,-4,33,107,13.34
101166,29,-3,32,106,13.34
101167,29,-4,33,106,14.01
101168,29,-4,33,106,13.09
101169,29,-4,33,104,12.42
101170,29,-4,33,105,13.96
101171,28,-3,31,104,13.32
101172,28,-4,32,106,13.17
101173,29,-4,33,115,13.74
101174,28,-4,32,112,13.35
101175,28,-4,32,113,12.72
101176,28,-4,32,108,12.61
101177,28,-4,32,113,13.11
101178,29,-4,33,112,14.06
101179,29,-4,33,111,14.24
101180,30,-3,33,117,16.16
101181,29,-4,33,118,14.96
101182,29,-4,33,113,15.41
101184,29,-4,33,119,14.73
101186,29,-4,33,116,13.31
101187,30,-4,34,113,12.62
101188,30,-5,35,101,11.63
101190,31,-4,35,104,12.28
101196,28,-7,35,41,4.39
101199,27,-9,36,46,6.6
101202,22,-12,34,54,5.02
101204,15,-16,31,85,5.02
101206,25,-12,37,37,3.07
101208,29,-8,37,41,4.11
101210,26,-10,36,30,3.06
101213,22,-10,32,38,2.92
101219,18,-14,32,44,3.56
101221,24,-11,35,40,3.56
101223,18,-14,32,64,6.78
101225,19,-13,32,54,4.39
101226,23,-15,38,38,3.65
101228,23,-15,38,37,2.24
101230,19,-14,33,50,3.4
101232,19,-15,34,56,2.81
101233,17,-15,32,60,2.95
101235,21,-12,33,34,2.61
101240,25,-14,39,26,2.72
101241,20,-18,38,51,3.24
101247,21,-16,37,50,3.6
101248,23,-17,40,35,2.74
101250,23,-12,35,58,4.18
101253,24,-12,36,44,3.44
101255,22,-12,34,42,2.78
101259,28,-8,36,40,2.95
101263,24,-11,35,72,3.6
101264,24,-10,34,52,3.62
101265,24,-11,35,53,4.01
101268,27,-12,39,45,3.51
101275,25,-11,36,73,3.93
101277,27,-9,36,36,5.3
101279,26,-8,34,56,3.85
101284,29,-9,38,39,3.49
101285,24,-10,34,42,3.91
101292,31,-9,40,31,3.49
101294,25,-9,34,51,4.01
101296,31,-8,39,33,2.95
101307,21,-14,35,71,4.59
101308,22,-13,35,52,3.61
101311,22,-11,33,52,3.45
101312,20,-11,31,81,4.66
101314,24,-10,34,38,3.17
101317,23,-11,34,56,3.67
101321,26,-9,35,56,4.2
101379,24,-6,30,112,3.34
101381,20,-10,30,87,2.79
101382,23,-8,31,118,3.51
101384,26,-9,35,33,2.31
101396,30,-1,31,99,4.48
101397,34,1,33,76,7.33
101398,30,-1,31,123,5.73
101401,33,1,32,94,7.23
101402,26,-3,29,129,4.67
101403,28,-2,30,133,5.48
101404,32,1,31,85,6.71
101405,24,-7,31,129,4.21
101406,33,1,32,96,5.93
101409,33,2,31,80,7.33
101411,31,-1,32,140,5.67
101412,31,1,30,142,6.48
101413,33,3,30,55,7.42
101414,33,2,31,83,8.92
101415,29,5,24,113,6.89
101416,30,3,27,101,6.83
101417,28,4,24,116,6.7
101418,30,3,27,103,5.17
101420,34,2,32,55,5.17
101421,30,3,27,115,5.17
101422,34,2,32,52,4.8
101423,32,1,31,92,3.74
101424,27,4,23,178,5.3
101426,30,3,27,132,4.22
101427,31,2,29,128,3.54
101428,29,2,27,140,4.11
101429,29,-2,31,112,14.31
101430,29,-3,32,112,14.14
101431,29,-3,32,113,14.3
101432,28,-3,31,114,13.97
101433,28,-3,31,115,13.91
101435,29,-3,32,116,14.48
101436,29,-2,31,116,15.9
101439,29,-2,31,119,17.16
101440,29,-2,31,118,17.05
101441,29,-3,32,118,15.24
101444,29,-3,32,111,14.35
101445,29,-3,32,117,16.32
101448,30,-1,31,113,15.76
101456,27,-5,32,109,13.91
101457,28,-5,33,94,11.03
101458,28,-4,32,100,12.67
101460,27,-5,32,95,12.37
101461,28,-5,33,92,12.37
101462,27,-5,32,97,12.18
101463,28,-4,32,94,11.97
101464,28,-4,32,99,12.44
101466,29,-4,33,95,11.06
101469,29,-4,33,101,12.76
101471,27,-4,31,105,12.99
101472,28,-4,32,99,12.86
101473,25,-6,31,104,12.37
101474,26,-5,31,101,12.15
101475,23,-7,30,147,16.73
101476,26,-6,32,135,14.58
101477,24,-8,32,146,16.73
101478,24,-7,31,126,14.5
101480,25,-6,31,134,15.68
101481,26,-5,31,124,15.06
101482,24,-6,30,140,14.86
101484,25,-6,31,126,14.36
101490,27,-5,32,112,15.25
101491,27,-5,32,124,12.92
101492,28,-4,32,115,12.63
101494,27,-5,32,121,12.94
101495,28,-5,33,119,13.17
101496,27,-5,32,120,12.92
101497,28,-5,33,118,13.22
101498,28,-5,33,117,12.77
101499,28,-5,33,115,13.33
101500,28,-5,33,116,13.58
101501,28,-5,33,119,13.22
101503,28,-5,33,119,14.01
101504,28,-5,33,111,14.07
101505,28,-5,33,112,14.17
101508,27,-5,32,109,13.53
101509,28,-5,33,108,14.42
101510,28,-5,33,111,14.17
101511,27,-4,31,103,13.08
101513,28,-4,32,115,12.67
101514,28,-5,33,114,13.12
101515,29,-5,34,107,14.28
101516,29,-4,33,104,13.41
101517,28,-5,33,114,13.07
101518,28,-4,32,111,13.78
101519,28,-4,32,107,14.07
101520,28,-5,33,103,12.74
101522,28,-5,33,109,14.3
101525,28,-5,33,102,13.52
101526,27,-5,32,106,13.78
101528,27,-5,32,99,13.55
101529,28,-5,33,102,12.37
101530,28,-5,33,104,12.79
101531,28,-5,33,106,12.11
101532,28,-5,33,101,13.22
101533,28,-5,33,100,12.76
101534,28,-5,33,102,12.65
101535,28,-5,33,104,13.16
101536,27,-5,32,101,14.25
101537,28,-5,33,102,12.79
101538,28,-5,33,102,14.26
101539,28,-5,33,99,12.49
101540,28,-5,33,102,13.07
101541,27,-5,32,100,13.19
101542,29,-4,33,105,12.73
101543,28,-4,32,109,13.16
101544,28,-4,32,103,13.53
101546,28,-5,33,99,13.29
101547,28,-5,33,97,14.12
101548,28,-4,32,110,15.37
101549,29,-4,33,109,16.51
101550,29,-4,33,114,17.76
101551,29,-4,33,107,14.5
101553,29,-4,33,102,14.69
101555,28,-5,33,101,14.77
101556,28,-6,34,102,13.98
101558,28,-5,33,113,14.78
101559,28,-5,33,110,14.83
101560,27,-6,33,103,13.84
101561,28,-5,33,112,15.13
101562,28,-5,33,110,14.59
101563,28,-5,33,112,14.7
101564,29,-5,34,108,13.42
101565,30,-5,35,99,12.42
101566,30,-5,35,98,13.02
101567,30,-6,36,97,12.71
101569,30,-6,36,95,12.14
101570,29,-6,35,96,11.96
101579,28,-10,38,48,5.15
101580,27,-10,37,53,5.67
101582,28,-9,37,47,6.72
101587,23,-10,33,64,5.62
101588,26,-12,38,47,4.87
101589,19,-11,30,74,4.87
101591,18,-13,31,84,5.5
101593,18,-14,32,53,4.08
101594,20,-11,31,68,6.01
101596,17,-13,30,69,5.11
101599,17,-14,31,63,4.78
101601,22,-10,32,47,5.63
101602,20,-11,31,75,6.03
101603,21,-14,35,63,4.21
101607,18,-15,33,52,3.44
101608,19,-17,36,71,3.34
101610,20,-16,36,59,2.98
101613,18,-16,34,75,3.13
101614,21,-15,36,49,4.16
101615,19,-12,31,71,3.52
101616,24,-13,37,52,2.87
101617,21,-15,36,47,4.58
101618,18,-14,32,80,3.91
101619,27,-14,41,36,3.65
101620,24,-9,33,48,3.73
101623,21,-14,35,66,3.07
101625,23,-12,35,60,3.68
101630,19,-15,34,85,4.96
101633,25,-13,38,57,3.39
101634,26,-12,38,44,3.37
101635,29,-12,41,39,3.12
101638,27,-10,37,43,3.69
101644,25,-12,37,51,4
101646,17,-15,32,108,4.01
101648,26,-13,39,50,3.95
101649,19,-15,34,86,4.38
101653,28,-9,37,40,3.78
101659,24,-10,34,58,3.96
101660,22,-9,31,56,3.92
101663,27,-10,37,41,4
101670,27,-10,37,37,3.34
101672,28,-9,37,35,4.84
101677,24,-10,34,41,3.85
101684,29,-7,36,30,3.13
101687,25,-9,34,42,3.23
101693,25,-9,34,45,4.27
101696,25,-14,39,53,4.24
101698,24,-10,34,67,3.57
101705,28,-10,38,38,3.41
101709,25,-12,37,54,3.59
101710,24,-12,36,47,3.48
101750,25,-7,32,64,2.4
101751,26,-3,29,162,5.97
101752,25,-8,33,113,4.06
101754,28,1,27,151,6.18
101756,29,-1,30,163,6.66
101758,28,0,28,165,5.88
101761,26,-2,28,179,5.79
101762,28,-8,36,49,2.59
101763,24,-5,29,184,3.76
101764,28,-7,35,64,2.72
101765,29,-5,34,117,3.26
101766,26,-6,32,51,2.22
101769,25,-6,31,116,2.95
101770,31,-3,34,93,3.38
101772,33,2,31,69,7.26
101773,32,2,30,104,6.81
101774,30,0,30,161,6.58
101776,29,-1,30,200,6.83
101777,26,-2,28,199,6.3
101778,33,3,30,87,6.58
101779,26,-2,28,235,4.11
101780,29,1,28,184,6.09
101781,34,3,31,107,7.61
101782,25,-3,28,140,3.16
101783,27,-1,28,202,6.86
101786,34,3,31,58,3.45
101787,32,2,30,95,3.3
101788,28,0,28,129,3.1
101789,33,1,32,55,3.5
101790,30,0,30,151,3.19
101791,28,1,27,93,3.3
101792,22,-3,25,156,2.56
101793,25,-1,26,92,2.48
101794,29,3,26,123,3.5
101795,32,1,31,115,3.19
101796,30,2,28,141,3.05
101797,27,3,24,127,3.28
101798,28,2,26,200,2.53
101800,27,2,25,207,3.64
101801,26,1,25,197,3.63
101802,34,0,34,109,2.16
101803,28,1,27,202,3.13
101804,23,-3,26,188,2.76
101805,25,3,22,184,3.84
101806,26,-3,29,121,7.44
101813,27,-4,31,114,17.78
101814,27,-6,33,129,16.29
101816,28,-4,32,118,19.56
101820,25,-7,32,128,16.81
101822,27,-6,33,110,13.95
101824,28,-4,32,103,14.91
101825,27,-5,32,108,13.89
101826,27,-5,32,109,13.34
101828,27,-5,32,101,12.37
101829,26,-6,32,109,13.34
101831,25,-7,32,124,14.3
101833,25,-7,32,117,14.38
101834,25,-7,32,125,14.2
101835,25,-7,32,119,14.21
101838,27,-6,33,101,13.58
101839,26,-5,31,103,13.04
101841,25,-6,31,113,13.53
101845,26,-5,31,104,11.42
101847,25,-7,32,111,15.15
101848,26,-6,32,103,12.76
101852,25,-7,32,110,14.8
101860,28,-5,33,102,15.42
101862,27,-5,32,100,15.5
101864,27,-6,33,112,14.28
101865,27,-6,33,108,14.5
101867,27,-5,32,102,13.58
101868,27,-5,32,105,14.24
101870,27,-5,32,102,14.01
101873,27,-5,32,100,13.79
101876,27,-5,32,99,13.89
101878,27,-5,32,100,14.1
101881,27,-5,32,98,14.25
101883,27,-5,32,97,15.03
101884,27,-5,32,98,15.74
101885,27,-5,32,103,12.98
101886,27,-5,32,103,13.57
101887,27,-5,32,100,14.46
101888,27,-5,32,101,13.75
101889,27,-5,32,103,13.56
101890,27,-5,32,100,14.68
101891,27,-5,32,99,15.38
101892,27,-5,32,101,14.07
101894,28,-5,33,100,14.82
101895,27,-5,32,103,13.85
101896,27,-6,33,103,13.69
101898,27,-6,33,101,14.25
101899,26,-6,32,103,14.16
101900,27,-6,33,98,14.55
101901,27,-6,33,97,14.2
101902,27,-6,33,98,13.64
101903,27,-6,33,96,14.09
101904,27,-6,33,96,17.02
101907,27,-6,33,94,18.1
101909,27,-6,33,99,14.56
101910,27,-7,34,99,15.09
101911,28,-7,35,93,11.96
101912,30,-6,36,96,11.19
101919,26,-7,33,55,7.58
101921,23,-9,32,51,6.59
101925,23,-9,32,51,5.95
101926,22,-14,36,69,4.15
101930,20,-12,32,69,5.5
101932,22,-10,32,55,5.63
101933,20,-16,36,64,4.87
101935,19,-13,32,58,4.88
101936,20,-13,33,47,4.76
101941,21,-12,33,49,4.83
101942,22,-12,34,48,3.8
101945,20,-15,35,85,4.02
101947,21,-14,35,55,2.8
101948,24,-15,39,57,4.11
101950,21,-14,35,59,3.96
101952,22,-13,35,83,5.01
101955,21,-14,35,97,5.43
101962,24,-11,35,61,3.24
101964,24,-12,36,74,3.86
101965,22,-13,35,76,4.54
101972,27,-11,38,47,3.1
101991,22,-14,36,53,3.49
101992,25,-13,38,38,2.82
101995,24,-11,35,42,2.63
102002,27,-14,41,35,3.45
102004,25,-13,38,40,3.46
102006,20,-15,35,64,3.82
102008,19,-16,35,76,4.18
102020,24,-15,39,59,2.95
102022,26,-9,35,55,4.9
102024,26,-11,37,62,4.61
102061,25,-8,33,85,2.88
102062,26,-8,34,89,3.09
102063,25,-6,31,79,3.26
102064,27,-6,33,46,2.58
102065,26,-7,33,89,3.01
102066,25,-6,31,62,2.08
102067,24,-7,31,108,2.49
102069,25,-9,34,62,1.85
102070,27,-7,34,55,2.28
102071,26,-7,33,38,1.85
102072,23,-4,27,226,5.48
102073,28,-5,33,105,2.66
102074,31,1,30,126,4.39
102075,28,-7,35,87,2.6
102076,27,-6,33,137,2.64
102077,31,1,30,97,4.19
102078,23,-7,30,148,3.24
102079,29,0,29,104,4.38
102080,23,-8,31,102,3.08
102081,24,-5,29,112,2.99
102082,29,-1,30,121,4.43
102083,26,-9,35,58,2.33
102084,26,-8,34,52,2.21
102085,26,-5,31,114,2.93
102087,29,-6,35,47,2.1
102088,34,2,32,76,4.03
102089,34,2,32,70,3.21
102090,26,0,26,162,2.52
102091,32,-1,33,85,2.48
102092,35,2,33,101,6.12
102093,35,2,33,90,4.12
102094,27,-1,28,118,2.23
102095,35,2,33,109,6.18
102096,28,-1,29,153,4.94
102097,28,-1,29,126,3.95
102098,34,2,32,151,5.14
102099,33,0,33,113,4.84
102100,27,-4,31,124,3.05
102101,31,0,31,231,5.25
102102,32,1,31,210,4.88
102103,31,-1,32,130,3.51
102104,31,1,30,162,2.45
102105,26,-2,28,194,2.59
102106,29,1,28,152,2.52
102107,30,-1,31,160,2.68
102108,27,-1,28,189,2.51
102109,29,3,26,159,2.89
102111,28,-1,29,189,1.87
102112,27,3,24,157,2.86
102113,30,-2,32,122,1.92
102114,27,-3,30,147,2.21
102115,30,-1,31,140,2.08
102116,33,2,31,137,2.18
102117,26,0,26,214,3.14
102118,33,3,30,175,2.6
102119,25,4,21,201,3.74
102120,26,3,23,213,4.48
102122,25,-4,29,123,5.58
102124,26,-4,30,124,11
102125,26,-4,30,129,11.79
102126,26,-4,30,124,11.27
102127,27,-5,32,126,11.89
102128,26,-6,32,125,11.87
102131,27,-4,31,124,11.38
102132,26,-4,30,123,14.55
102133,26,-6,32,130,12.2
102134,26,-6,32,126,11.76
102135,27,-6,33,131,12.45
102136,27,-5,32,129,12.96
102137,27,-6,33,134,12.54
102138,27,-5,32,130,14.13
102140,26,-6,32,128,11.96
102142,26,-7,33,130,12.16
102146,27,-4,31,129,15.49
102147,27,-5,32,128,15.27
102148,27,-5,32,137,14.16
102149,26,-6,32,134,14.66
102151,26,-7,33,130,13.21
102152,28,-6,34,116,13.77
102155,26,-7,33,132,13.81
102157,24,-9,33,137,13.39
102158,24,-7,31,130,13.14
102159,26,-7,33,115,11.96
102160,27,-7,34,114,12.13
102162,25,-7,32,121,11.81
102163,26,-6,32,122,12.36
102164,25,-7,32,116,11.86
102165,27,-6,33,113,12.04
102166,27,-6,33,115,11.51
102168,27,-7,34,121,10.96
102169,27,-7,34,122,10.99
102170,23,-9,32,129,13.45
102171,24,-9,33,123,12.58
102172,25,-7,32,129,15.48
102173,25,-7,32,117,15.42
102175,23,-9,32,129,14.09
102177,25,-7,32,109,11.39
102178,25,-7,32,113,12.22
102179,24,-9,33,113,11.98
102183,25,-8,33,113,11.94
102185,24,-8,32,115,11.68
102186,25,-8,33,112,11.44
102189,25,-7,32,113,13.47
102191,24,-7,31,112,13.82
102193,23,-7,30,125,11.68
102195,25,-7,32,101,11.68
102197,26,-7,33,94,10.7
102198,25,-7,32,96,12.97
102200,25,-8,33,106,12.04
102202,26,-7,33,113,12.69
102203,25,-7,32,111,13.88
102205,25,-7,32,105,13.12
102206,25,-7,32,104,13.06
102207,25,-7,32,105,12.01
102208,26,-7,33,102,12.08
102211,24,-8,32,97,11.74
102212,26,-7,33,93,11.61
102213,24,-8,32,99,11.99
102214,24,-8,32,106,12.73
102215,25,-8,33,105,12.45
102217,25,-7,32,89,11.5
102221,26,-6,32,107,13.37
102222,25,-6,31,110,13.39
102223,26,-6,32,112,13.79
102224,25,-7,32,112,13.19
102225,25,-7,32,111,12.48
102226,24,-7,31,111,13.14
102227,25,-7,32,113,12.8
102228,26,-7,33,110,11.96
102229,24,-8,32,115,12.32
102231,25,-7,32,108,11.96
102232,25,-7,32,112,12.18
102238,24,-8,32,107,12.03
102239,24,-8,32,107,11.02
102244,24,-8,32,115,13.42
102247,25,-7,32,116,13.82
102249,26,-6,32,113,14.17
102251,26,-7,33,112,13.9
102252,25,-7,32,113,12.7
102253,26,-7,33,112,13.94
102259,27,-5,32,96,14.31
102264,26,-7,33,109,15.19
102278,27,-6,33,87,14.43
102279,28,-6,34,88,13.67
102280,26,-7,33,93,14.3
102282,26,-5,31,94,16.55
102285,28,-8,36,94,13.22
102286,28,-8,36,93,12.12
102287,28,-8,36,91,12.45
102291,21,-14,35,63,4.25
102292,20,-14,34,117,6.03
102307,27,-8,35,54,4.03
102324,26,-10,36,60,2.53
102341,25,-8,33,30,1.42
102345,26,-8,34,46,1.89
102346,27,-7,34,39,1.88
102347,27,-5,32,50,2.38
102348,23,-8,31,75,2.37
102349,24,-9,33,73,2.46
102350,24,-8,32,60,1.98
102351,22,-8,30,80,2.29
102352,28,-7,35,45,1.65
102353,27,-7,34,38,1.47
102354,28,-7,35,40,1.13
102355,26,-7,33,53,1.63
102356,22,-9,31,97,2.92
102357,30,-4,34,61,2.34
102358,27,-4,31,58,2.59
102359,29,-3,32,170,4.72
102360,28,-4,32,170,3.27
102361,25,-6,31,54,2.14
102362,28,-5,33,60,2.28
102364,29,-6,35,76,2.76
102365,26,-6,32,58,2.1
102367,28,-5,33,94,3.08
102368,26,-4,30,116,2.85
102369,27,-6,33,49,2.03
102370,24,-5,29,117,2.7
102371,27,-7,34,54,1.93
102373,28,-8,36,32,1.58
102374,29,0,29,210,4.66
102375,30,-4,34,128,3.69
102376,23,-3,26,176,3.7
102378,21,-5,26,114,2.86
102379,30,-4,34,54,1.75
102380,22,-4,26,121,2.78
102381,21,-6,27,65,2.53
102382,27,-5,32,52,1.76
102384,30,-4,34,56,2.2
102385,28,-3,31,72,2.12
102386,29,-2,31,74,1.8
102387,33,2,31,154,2.48
102388,31,2,29,218,2.71
102389,29,-1,30,109,1.97
102390,32,0,32,148,2.17
102391,33,3,30,154,1.8
102392,24,2,22,168,3.01
102393,21,-4,25,156,2.29
102394,27,2,25,207,2.77
102395,28,-1,29,330,2.37
102396,23,-4,27,98,1.61
102397,28,-1,29,227,1.72
102398,26,-1,27,397,2.96
102399,23,1,22,286,3.15
102400,22,-3,25,236,2.38
102401,30,-1,31,64,1.4
102403,32,-1,33,148,1.8
102404,27,0,27,253,3.14
102405,25,1,24,255,2.76
102406,28,-2,30,180,2.32
102407,27,-2,29,220,2.44
102408,24,1,23,241,3.44
102409,27,-5,32,120,11.39
102410,26,-6,32,119,11.48
102411,26,-6,32,118,11.53
102412,26,-7,33,122,11.67
102417,27,-7,34,124,13.35
102418,25,-6,31,125,12.91
102419,25,-8,33,124,11.75
102422,27,-6,33,119,13.73
102423,27,-7,34,116,12.61
102424,26,-8,34,121,10.8
102426,24,-9,33,122,10.34
102427,26,-8,34,118,11.08
102428,27,-7,34,113,9.7
102429,25,-9,34,117,10.63
102432,25,-7,32,125,12.35
102433,25,-7,32,127,13.15
102434,26,-7,33,122,12.91
102435,26,-8,34,130,12.08
102436,26,-7,33,120,11.63
102437,26,-8,34,121,11.55
102438,27,-7,34,117,11.39
102440,25,-9,34,140,12.01
102441,25,-9,34,128,10.82
102442,25,-9,34,120,11.33
102446,25,-8,33,126,11.26
102447,25,-8,33,131,10.06
102448,25,-9,34,119,9.85
102449,27,-8,35,115,10.04
102450,25,-9,34,125,9.56
102451,24,-9,33,127,9.95
102452,25,-9,34,131,11.28
102453,26,-9,35,106,9.58
102454,21,-11,32,161,13.9
102457,24,-8,32,119,9.75
102460,23,-11,34,133,11.48
102461,25,-8,33,133,13.02
102462,26,-8,34,112,11.39
102463,27,-7,34,107,11.07
102464,27,-7,34,108,10.47
102467,24,-9,33,125,11.69
102468,25,-9,34,118,11.58
102469,25,-9,34,113,11.82
102470,27,-6,33,98,13.02
102471,26,-8,34,103,10
102472,23,-9,32,118,12.51
102474,22,-10,32,138,12.4
102475,24,-9,33,129,15.03
102476,24,-10,34,113,12.42
102477,24,-8,32,120,11.89
102479,24,-9,33,109,11.5
102480,24,-9,33,115,11.64
102481,23,-10,33,107,10.18
102482,24,-9,33,112,11.48
102484,24,-10,34,104,10
102486,24,-9,33,100,10.57
102487,25,-8,33,107,11.26
102488,25,-8,33,95,9.66
102490,24,-8,32,108,11.41
102491,25,-8,33,99,10.22
102492,23,-8,31,108,11.07
102493,25,-9,34,114,11.63
102494,26,-8,34,110,11.73
102495,25,-8,33,111,11.52
102496,24,-7,31,110,11.67
102499,25,-8,33,107,10.61
102500,24,-8,32,109,11.69
102501,25,-8,33,104,10.9
102502,24,-8,32,107,12.79
102503,24,-9,33,110,11.48
102505,25,-8,33,105,12.78
102506,25,-7,32,96,11.15
102507,25,-7,32,96,10.29
102508,26,-7,33,92,10.82
102509,25,-7,32,91,10.49
102510,25,-7,32,90,10.32
102511,25,-8,33,100,10.88
102515,25,-7,32,94,12.46
102519,26,-6,32,90,10.07
102520,25,-7,32,104,12.56
102521,26,-6,32,90,11.42
102522,24,-8,32,94,10.75
102530,23,-8,31,95,11.13
102531,24,-8,32,92,11.08
102534,26,-6,32,87,10.99
102535,26,-6,32,89,10.56
102536,24,-8,32,105,11.46
102539,25,-8,33,116,12.36
102540,25,-7,32,111,12.79
102545,25,-7,32,116,12.35
102548,25,-7,32,120,13.01
102550,26,-7,33,80,14.07
102551,26,-7,33,81,12.19
102553,27,-7,34,97,13.71
102554,26,-6,32,90,15.83
102555,27,-9,36,88,14.14
102556,26,-9,35,87,13.31
102557,27,-9,36,92,12.61
102558,28,-9,37,92,12.35
102561,24,-13,37,56,4.94
102572,21,-13,34,78,4.03
102574,21,-14,35,87,3.59
102577,24,-15,39,66,3.94
102578,22,-13,35,113,5.06
102580,20,-12,32,114,2.83
102582,22,-12,34,72,3.23
102585,22,-12,34,92,4.67
102589,25,-10,35,92,3.66
102590,24,-14,38,59,3.26
102595,24,-10,34,86,3.87
102599,24,-10,34,108,3.66
102606,28,-9,37,35,1.45
102608,25,-6,31,82,1.81
102611,27,-7,34,47,1.47
102615,25,-8,33,47,2.45
102616,26,-7,33,54,1.99
102617,22,-9,31,54,1.67
102618,25,-7,32,59,1.76
102619,25,-7,32,48,1.99
102620,28,-6,34,41,1.95
102621,26,-7,33,48,1.88
102622,25,-8,33,48,1.73
102624,24,-8,32,61,2.44
102625,27,-8,35,49,1.81
102626,24,-7,31,61,1.97
102628,27,-7,34,39,1.52
102629,26,-6,32,60,2.07
102630,28,-7,35,36,1.64
102632,27,-7,34,45,1.97
102633,27,-7,34,50,1.7
102634,26,-7,33,50,1.65
102635,28,-8,36,45,1.72
102636,26,-8,34,64,1.67
102638,26,-8,34,70,1.47
102639,27,-8,35,58,1.77
102640,27,-9,36,54,1.6
102641,26,-9,35,83,1.54
102643,26,-8,34,76,1.69
102644,29,-5,34,52,2.04
102645,25,-1,26,73,2.24
102646,22,-1,23,110,2.51
102647,26,-6,32,66,2.46
102648,24,0,24,86,2.71
102650,27,-7,34,73,2.06
102651,27,-3,30,80,2.69
102652,25,-6,31,107,1.7
102653,20,-8,28,158,2.61
102654,30,-2,32,64,2.43
102655,26,-7,33,79,1.82
102656,29,-2,31,89,2.3
102657,23,-6,29,164,2.03
102658,26,-4,30,110,2.25
102659,30,-2,32,87,1.97
102661,26,-1,27,92,2.42
102662,24,-7,31,116,1.74
102663,28,-3,31,115,2.13
102664,29,-2,31,111,2.4
102665,27,-4,31,142,2.02
102666,27,-2,29,83,1.76
102667,27,-2,29,161,2.47
102668,27,1,26,86,1.99
102669,28,1,27,182,3.15
102670,26,0,26,92,2.32
102671,31,0,31,105,2.04
102672,25,0,25,392,2.83
102673,31,0,31,77,2.17
102674,28,3,25,188,2.55
102675,27,1,26,85,2.49
102677,27,1,26,110,2.3
102678,23,-1,24,381,3.01
102679,25,-1,26,129,2.98
102680,21,-2,23,178,3.2
102681,28,2,26,118,2.32
102682,24,0,24,268,2.55
102683,27,1,26,111,2.46
102684,29,0,29,83,3.67
102685,24,1,23,194,3.17
102687,23,3,20,230,2.62
102688,28,0,28,257,2.84
102691,28,2,26,264,2.39
102693,24,1,23,407,3.54
102694,22,3,19,209,2.53
102695,25,-8,33,119,4.81
102696,25,-8,33,118,7.4
102697,25,-7,32,119,5.21
102699,27,-7,34,111,8.19
102702,25,-8,33,120,8.81
102703,27,-8,35,122,8.31
102704,26,-8,34,117,8.45
102705,26,-10,36,122,7.56
102706,26,-10,36,119,7.89
102707,25,-10,35,119,7.35
102710,25,-8,33,120,9.08
102711,25,-10,35,120,7.17
102712,25,-11,36,121,6.45
102714,25,-9,34,116,9.42
102715,26,-9,35,105,8.52
102716,25,-8,33,121,9.14
102717,25,-9,34,116,8.99
102720,26,-10,36,118,8.81
102721,25,-10,35,113,8.52
102724,25,-10,35,116,8.37
102725,26,-9,35,110,4.69
102726,25,-10,35,110,8.23
102727,25,-10,35,115,7.87
102728,24,-8,32,116,8.25
102730,24,-10,34,106,8.51
102731,22,-11,33,118,8.43
102732,26,-10,36,117,6.75
102736,25,-11,36,117,7.66
102737,26,-10,36,114,8.4
102738,21,-13,34,158,9.24
102739,23,-11,34,104,9.19
102740,26,-9,35,104,8.85
102741,23,-10,33,127,9.18
102742,24,-8,32,109,9.48
102743,23,-11,34,128,8.65
102744,22,-11,33,167,10.43
102745,25,-10,35,103,8.69
102749,25,-10,35,110,7.87
102750,22,-11,33,142,10.65
102751,24,-10,34,121,7.65
102752,23,-11,34,133,9.9
102753,25,-10,35,100,8.07
102754,25,-10,35,102,7.59
102755,25,-11,36,107,7.67
102758,22,-13,35,137,9.8
102759,23,-12,35,104,7.68
102760,23,-12,35,109,8.09
102761,22,-12,34,124,11.19
102763,27,-8,35,101,11
102764,24,-8,32,123,10.86
102765,25,-9,34,114,9.03
102766,25,-10,35,114,9.37
102767,25,-10,35,107,9.9
102769,25,-10,35,112,9.2
102770,23,-12,35,120,8.03
102771,24,-11,35,111,7.08
102772,26,-10,36,101,9.43
102773,23,-12,35,122,7.35
102775,24,-11,35,117,10.04
102776,24,-11,35,110,7.42
102777,24,-11,35,107,6.84
102778,25,-9,34,117,10.78
102779,25,-9,34,123,12
102780,23,-9,32,128,9.95
102781,23,-10,33,126,11.32
102783,22,-10,32,141,9.77
102784,23,-10,33,132,12.79
102785,23,-11,34,137,12.06
102787,22,-13,35,124,7.53
102788,22,-12,34,104,7.06
102789,23,-12,35,120,8.45
102790,22,-11,33,133,10.45
102791,23,-12,35,129,10.37
102792,23,-13,36,120,9.45
102794,23,-12,35,109,7.31
102795,22,-13,35,120,8.43
102796,23,-13,36,118,8.5
102798,25,-9,34,123,12.36
102799,26,-8,34,114,12.72
102800,26,-7,33,110,12.15
102802,25,-9,34,126,12.84
102804,24,-11,35,129,12.24
102805,24,-9,33,129,13.91
102806,23,-12,35,127,11.23
102809,24,-10,34,121,10.61
102810,23,-12,35,143,13.92
102811,23,-11,34,160,12.14
102813,24,-9,33,128,16.02
102814,23,-12,35,123,10.61
102815,24,-11,35,107,10.13
102816,25,-7,32,99,11.05
102817,26,-6,32,101,11.05
102818,26,-5,31,95,11.47
102819,25,-7,32,123,13.88
102822,26,-6,32,92,12.54
102824,26,-5,31,82,13.83
102827,26,-7,33,78,12.99
102828,26,-7,33,81,11.23
102830,26,-7,33,80,11.26
102831,26,-8,34,76,10.83
102833,26,-8,34,92,12.73
102834,26,-8,34,90,12.5
102835,25,-9,34,86,11.63
102836,25,-9,34,82,10.43
102837,27,-11,38,86,12.44
102846,19,-14,33,54,3.02
102847,21,-14,35,58,3.37
102848,21,-13,34,51,3.4
102851,23,-12,35,65,3.14
102852,24,-12,36,78,3.48
102854,23,-13,36,79,3.74
102856,18,-16,34,75,2.98
102857,21,-16,37,72,2.77
102860,19,-15,34,93,3.56
102861,19,-15,34,101,4.09
102864,20,-13,33,71,3.42
102867,26,-13,39,52,4.13
102869,24,-11,35,58,3.25
102870,24,-14,38,92,4.13
102872,26,-12,38,47,3.63
102888,23,-12,35,80,2.48
102891,22,-14,36,66,1.89
102893,29,-10,39,61,2.4
102895,24,-11,35,82,2.69
102899,25,-11,36,89,2.86
102903,28,-9,37,77,3.09
102905,27,-9,36,48,1.83
102908,27,-9,36,39,1.78
102909,28,-9,37,42,1.45
102910,28,-10,38,40,1.71
102911,26,-9,35,36,1.48
102913,27,-10,37,34,1.46
102914,23,-10,33,64,1.96
102918,25,-8,33,72,1.42
102920,25,-7,32,83,1.88
102922,23,-7,30,54,1.48
102924,25,-8,33,63,1.63
102925,24,-8,32,83,1.58
102928,27,-9,36,40,1.28
102929,26,-7,33,67,1.57
102932,24,-7,31,72,1.88
102933,21,-8,29,182,1.72
102934,24,-7,31,86,1.64
102935,23,-7,30,153,1.93
102936,21,-6,27,186,2.4
102937,23,-7,30,139,1.83
102938,30,-2,32,105,2.3
102939,22,-7,29,145,1.83
102940,24,-5,29,161,2.22
102941,25,-1,26,149,2.4
102942,26,-6,32,150,1.99
102943,26,-2,28,160,2.47
102944,21,-4,25,182,2.4
102946,23,-3,26,167,2.26
102947,25,-1,26,180,2.71
102948,28,-2,30,131,2.44
102949,23,-2,25,188,2.5
102950,26,0,26,155,3.33
102951,26,-1,27,130,2.67
102952,25,1,24,142,4.68
102953,28,-2,30,139,2.92
102954,26,0,26,166,3.32
102956,28,0,28,131,2.78
102957,28,1,27,98,4.16
102958,25,2,23,115,2.55
102959,28,1,27,94,3.46
102960,24,3,21,193,3.18
102963,26,2,24,193,2.8
102964,24,2,22,204,3.16
102968,25,1,24,163,2.82
102969,26,2,24,129,3.21
102970,26,0,26,125,4.55
102971,27,2,25,145,3.39
102973,19,3,16,162,1.9
102975,21,2,19,178,3.78
102976,24,-9,33,129,5.23
102979,22,-8,30,127,4.31
102980,24,-9,33,126,5.06
102981,25,-10,35,124,4.94
102983,25,-10,35,122,5.11
102984,24,-11,35,117,4.96
102987,24,-7,31,135,4.68
102988,24,-7,31,131,6.54
102990,25,-9,34,120,5.62
102991,25,-8,33,121,6.86
102992,25,-8,33,120,6.57
102993,25,-9,34,124,5.35
102994,25,-9,34,113,5.95
102996,25,-10,35,124,5.23
102997,25,-9,34,118,5.37
102999,24,-9,33,108,5.45
103000,25,-10,35,112,5.3
103003,24,-12,36,114,5.19
103004,25,-11,36,105,6.86
103006,25,-11,36,104,5.13
103007,23,-7,30,125,6.28
103008,24,-8,32,118,6.8
103009,25,-9,34,126,6.57
103010,25,-9,34,112,7.12
103012,23,-9,32,126,4.37
103013,25,-9,34,117,6.21
103015,25,-9,34,110,7.04
103016,23,-7,30,117,6.44
103017,25,-10,35,115,6.3
103018,26,-11,37,111,6.45
103019,25,-10,35,109,6.5
103021,25,-11,36,112,5.96
103022,24,-10,34,113,6.22
103023,24,-12,36,122,5.85
103024,23,-8,31,111,5.61
103027,25,-11,36,110,5.98
103028,25,-11,36,108,5.62
103029,25,-12,37,109,5.6
103030,24,-12,36,105,5.24
103031,25,-12,37,109,5.56
103032,25,-12,37,107,5.47
103033,25,-12,37,106,5.18
103034,26,-9,35,117,9.25
103035,25,-10,35,119,6.86
103036,25,-10,35,117,7.61
103037,24,-11,35,118,6.04
103038,26,-10,36,116,6.16
103039,25,-10,35,114,7.34
103041,24,-11,35,114,6.88
103042,25,-11,36,112,7.07
103043,24,-11,35,109,6.35
103044,25,-11,36,116,6.06
103045,25,-11,36,111,6.18
103046,22,-12,34,136,7.08
103048,21,-13,34,125,7.83
103049,24,-12,36,116,5.99
103051,24,-12,36,117,6.2
103052,23,-13,36,134,7.04
103053,22,-14,36,107,6.02
103054,23,-14,37,119,5.98
103055,21,-15,36,134,6.7
103056,23,-12,35,136,7.62
103057,22,-12,34,138,9.17
103060,20,-13,33,161,7.04
103061,22,-12,34,130,10.84
103063,24,-12,36,99,8.17
103064,24,-12,36,100,7.23
103065,23,-12,35,123,8.19
103066,25,-12,37,93,7.38
103067,24,-13,37,102,6.3
103070,23,-13,36,104,7.28
103072,23,-13,36,111,8.31
103073,22,-14,36,102,5.7
103074,22,-13,35,111,8.13
103075,21,-13,34,113,8.29
103076,22,-13,35,111,7.36
103077,22,-14,36,121,7.9
103078,24,-11,35,96,8.28
103079,25,-11,36,93,7.82
103080,24,-12,36,101,7.44
103083,24,-11,35,96,7.73
103084,23,-12,35,132,8.94
103085,21,-13,34,148,9.22
103086,23,-12,35,114,8.06
103087,24,-11,35,109,7.97
103088,24,-13,37,102,7.69
103089,23,-13,36,112,8.17
103093,24,-11,35,114,10.17
103096,23,-14,37,115,8.64
103097,23,-12,35,116,10.6
103098,23,-13,36,112,8.14
103099,22,-12,34,127,10.61
103100,23,-11,34,116,11.31
103101,22,-13,35,130,10.49
103102,25,-9,34,91,8.53
103103,23,-12,35,110,6.18
103104,22,-13,35,114,10.6
103106,24,-11,35,97,7.89
103107,23,-12,35,101,9.4
103108,24,-10,34,90,7.89
103109,25,-9,34,84,6.3
103110,25,-10,35,85,5.77
103111,24,-12,36,104,6.89
103112,24,-12,36,105,8.45
103113,24,-11,35,97,8.38
103114,25,-10,35,92,10.56
103115,25,-10,35,87,8.39
103116,22,-13,35,121,8.43
103117,23,-13,36,115,8.12
103118,23,-13,36,114,8.39
103119,23,-12,35,112,10.48
103121,24,-12,36,112,9.42
103122,24,-12,36,104,7.47
103123,23,-12,35,109,7.94
103124,23,-12,35,110,8.16
103125,23,-12,35,112,9.16
103126,24,-12,36,108,7.53
103127,23,-12,35,109,8
103128,23,-12,35,108,7.83
103129,25,-11,36,97,9.42
103130,23,-12,35,117,9
103131,24,-11,35,95,8.48
103133,25,-11,36,93,8.68
103134,23,-12,35,120,11.27
103135,24,-11,35,108,10.85
103136,24,-10,34,108,10.55
103137,25,-9,34,106,11.37
103139,24,-11,35,113,10.45
103140,25,-10,35,97,9.91
103141,25,-10,35,99,10.56
103143,24,-11,35,106,9.93
103145,25,-8,33,74,8.34
103146,26,-9,35,79,9.67
103147,25,-9,34,76,9.11
103148,25,-10,35,77,9.52
103149,25,-10,35,86,8.93
103150,25,-9,34,81,9.12
103152,24,-9,33,80,10.09
103153,25,-6,31,84,11.42
103155,25,-6,31,85,10.87
103156,24,-7,31,87,10.36
103157,26,-12,38,81,11.38
103158,25,-13,38,83,11.76
103159,26,-13,39,83,10.71
103160,25,-14,39,83,11.05
103161,27,-12,39,83,12.91
103162,26,-13,39,86,11.64
103164,26,-13,39,83,12.96
103166,25,-12,37,60,4.53
103167,26,-11,37,56,3.69
103168,29,-13,42,41,3.59
103169,27,-12,39,59,4.89
103170,28,-12,40,50,3.68
103172,29,-13,42,42,3.18
103174,30,-13,43,33,2.79
103176,21,-13,34,62,2.68
103179,18,-15,33,71,2.46
103180,19,-14,33,59,3.91
103181,19,-14,33,65,3.34
103182,18,-14,32,75,3.47
103183,19,-15,34,74,3.19
103184,18,-14,32,72,3.55
103185,20,-13,33,76,3.32
103187,20,-15,35,54,2.87
103188,20,-12,32,69,2.99
103189,20,-13,33,80,3.48
103193,22,-16,38,99,2.81
103194,20,-15,35,133,3.53
103197,21,-15,36,132,4.15
103198,20,-15,35,101,3.98
103200,19,-16,35,77,2.91
103203,18,-14,32,81,2.62
103205,22,-15,37,53,2.55
103206,24,-14,38,33,3.6
103208,19,-15,34,135,3.32
103209,25,-14,39,71,3.67
103213,24,-15,39,81,4.64
103215,19,-14,33,91,3.6
103216,18,-15,33,91,3.18
103217,19,-12,31,66,2.49
103229,24,-12,36,39,1.48
103232,23,-12,35,55,2.26
103233,22,-11,33,55,1.64
103236,21,-12,33,64,2.14
103238,22,-13,35,59,2.19
103242,21,-12,33,79,2.11
103245,22,-13,35,72,2.32
103250,27,-11,38,54,2.29
103252,20,-11,31,72,2.19
103254,25,-10,35,104,2.66
103261,24,-9,33,91,2.67
103264,22,-10,32,116,3.49
103266,23,-14,37,104,1.99
103269,21,-12,33,125,2.37
103273,24,-10,34,88,2.9
103277,23,-11,34,102,2.57
103282,22,-13,35,107,2.29
103285,30,-9,39,70,2.62
103289,28,-10,38,66,2.32
103295,27,-10,37,72,2.44
103296,25,-9,34,78,2.7
103297,25,-9,34,48,1.85
103300,25,-9,34,114,2.79
103302,27,-11,38,59,2.02
103304,25,-9,34,48,1.74
103305,21,-10,31,94,2.61
103307,23,-10,33,90,2.54
103308,26,-9,35,47,1.76
103310,25,-8,33,60,1.92
103311,25,-9,34,67,1.73
103315,24,-9,33,70,2.1
103317,26,-7,33,45,1.6
103319,27,-7,34,36,1.33
103320,26,-7,33,38,1.8
103321,24,-7,31,45,1.73
103323,23,-7,30,51,1.55
103325,23,-8,31,73,2.19
103327,24,-7,31,50,1.98
103328,28,-5,33,41,1.55
103329,28,-5,33,41,1.9
103331,25,-7,32,41,1.4
103334,24,-8,32,55,2.16
103335,26,-5,31,32,1.55
103337,28,-5,33,27,1.87
103339,25,-6,31,46,1.56
103340,27,-4,31,34,1.9
103341,27,-5,32,36,1.94
103342,27,-4,31,40,1.64
103343,29,-5,34,35,1.55
103346,28,-6,34,29,1.8
103348,24,-6,30,98,2.3
103349,26,-5,31,45,1.63
103351,27,-4,31,49,2.1
103352,23,-4,27,220,3.11
103353,26,-4,30,47,2.02
103354,20,-6,26,207,2.91
103355,27,-5,32,41,2.02
103356,23,-4,27,185,3.02
103357,24,-3,27,213,2.77
103358,26,0,26,129,5.9
103360,25,-2,27,195,2.84
103361,28,-1,29,200,2.89
103362,27,2,25,188,4.45
103363,25,1,24,138,5.1
103364,22,-3,25,236,3.11
103365,24,-2,26,241,3.33
103366,25,0,25,154,4.81
103367,23,-3,26,243,3.32
103368,27,1,26,120,5.88
103369,25,0,25,158,4.86
103371,21,-1,22,256,4.23
103372,25,0,25,177,4.23
103373,21,0,21,231,5.62
103375,25,0,25,147,6.26
103376,23,-3,26,221,3.45
103377,20,-1,21,242,5.47
103379,24,1,23,212,3.48
103380,26,1,25,160,3.94
103382,23,-1,24,225,4.03
103383,26,0,26,173,4.06
103384,23,1,22,221,4.04
103385,26,2,24,204,3.63
103386,26,0,26,173,3.57
103388,21,2,19,187,3.32
103390,25,0,25,215,3.83
103391,20,2,18,219,3.94
103392,23,-9,32,126,3.83
103393,24,-10,34,120,5.03
103395,25,-12,37,114,4.57
103396,25,-12,37,114,4.85
103397,25,-11,36,114,4.63
103400,24,-12,36,113,4.48
103401,24,-13,37,112,4.75
103403,25,-13,38,111,4.38
103405,24,-13,37,113,5.01
103406,24,-13,37,109,4.47
103407,24,-13,37,107,4.08
103408,24,-14,38,105,4
103410,24,-12,36,113,4.88
103411,24,-13,37,112,5.23
103414,24,-13,37,112,5.05
103415,25,-12,37,109,5.01
103416,25,-12,37,108,4.94
103417,24,-13,37,113,4.78
103418,25,-13,38,111,4.95
103419,25,-12,37,115,4.83
103420,24,-13,37,112,4.99
103421,24,-13,37,111,4.32
103422,24,-13,37,115,4.97
103423,24,-13,37,110,4.3
103424,25,-12,37,111,4.81
103425,24,-13,37,108,4.28
103426,24,-13,37,109,4.27
103427,24,-13,37,109,4.45
103428,24,-13,37,107,4.38
103429,24,-13,37,108,4.31
103430,24,-13,37,107,4.74
103431,23,-14,37,107,4.05
103432,21,-16,37,130,6.54
103436,23,-14,37,105,4.21
103437,24,-14,38,107,4.38
103440,24,-13,37,111,5.19
103441,24,-13,37,111,5.2
103442,24,-13,37,113,5.2
103445,23,-14,37,122,5.7
103446,23,-13,36,114,5.43
103447,24,-13,37,113,5.1
103448,22,-14,36,121,5.81
103449,25,-12,37,114,4.76
103450,23,-14,37,122,5.2
103452,23,-14,37,109,4.71
103453,23,-14,37,119,5.5
103454,23,-14,37,99,4.55
103455,23,-15,38,128,5.35
103458,22,-15,37,137,6.37
103459,22,-14,36,101,5.43
103460,23,-15,38,108,4.71
103461,23,-14,37,104,5.19
103462,22,-14,36,106,5.23
103463,22,-14,36,105,4.87
103464,23,-15,38,107,4.87
103465,23,-15,38,102,4.39
103467,22,-15,37,105,4.83
103468,22,-14,36,129,5.44
103469,20,-15,35,143,6.89
103472,23,-14,37,102,5.68
103473,21,-15,36,112,6.81
103474,22,-14,36,99,5.13
103475,20,-15,35,124,8.26
103476,22,-14,36,103,4.85
103477,21,-14,35,110,6.27
103478,23,-14,37,106,5.07
103481,21,-14,35,118,5.86
103482,21,-14,35,107,6.96
103483,21,-14,35,108,6.68
103484,20,-14,34,109,6.64
103486,22,-14,36,108,6.43
103489,20,-13,33,123,7.16
103490,21,-14,35,112,7.69
103491,20,-13,33,120,7.72
103492,25,-10,35,79,8.49
103493,25,-10,35,88,9.61
103494,25,-9,34,77,7.52
103495,24,-8,32,80,8.82
103496,24,-8,32,76,8.78
103497,25,-13,38,77,8.23
103498,24,-13,37,80,9.4
103499,25,-13,38,77,8.63
103500,24,-14,38,77,7.98
103501,23,-15,38,79,7.82
103502,24,-15,39,82,9.3
103503,24,-15,39,82,8.99
103504,25,-14,39,83,9.38
103505,25,-15,40,80,9.02
103506,26,-14,40,82,11.96
103508,26,-14,40,76,10.62
103510,25,-16,41,72,9.58
103511,26,-15,41,69,10.49
103512,27,-14,41,67,14.08
103513,28,-13,41,38,3.24
103514,30,-12,42,35,2.81
103516,30,-13,43,37,2.61
103517,30,-13,43,37,3.98
103518,30,-13,43,37,3.17
103520,28,-11,39,53,2.65
103521,25,-8,33,55,2.8
103522,24,-9,33,57,2.29
103523,17,-15,32,105,3.15
103524,19,-13,32,80,3.41
103528,21,-13,34,85,3.31
103529,18,-14,32,108,2.92
103531,25,-12,37,44,2.49
103532,25,-13,38,63,2.85
103534,20,-11,31,82,2.84
103535,24,-11,35,41,2.73
103536,23,-13,36,50,1.98
103537,23,-14,37,45,1.86
103540,26,-10,36,47,2.38
103543,22,-12,34,45,2.31
103546,21,-11,32,69,2.16
103548,20,-12,32,85,2.41
103549,23,-12,35,71,2.51
103553,18,-16,34,120,2.73
103558,24,-12,36,89,2.44
103559,24,-13,37,97,2.8
103562,23,-13,36,111,3.04
103565,20,-14,34,115,2.54
103567,21,-14,35,92,2.64
103570,21,-14,35,93,2.3
103571,22,-14,36,86,3.16
103573,22,-12,34,101,2.83
103574,23,-13,36,89,2.26
103578,23,-15,38,81,2.07
103580,22,-14,36,107,3.22
103582,22,-15,37,108,2.94
103583,22,-13,35,88,2.67
103588,22,-11,33,105,2.76
103590,27,-8,35,102,2.92
103592,25,-13,38,96,2.68
103595,23,-10,33,119,2.85
103597,23,-11,34,113,2.83
103598,25,-8,33,68,2.47
103600,21,-9,30,90,2.27
103601,25,-11,36,98,2.8
103603,24,-11,35,102,3.21
103605,26,-6,32,54,2.16
103606,27,-6,33,55,2.32
103607,32,-3,35,44,2.06
103608,23,-9,32,100,2.7
103609,18,-12,30,116,2.83
103610,23,-9,32,105,3.21
103612,26,-8,34,87,3.52
103613,26,-7,33,59,2.23
103614,27,-8,35,63,2.35
103616,28,-7,35,67,2.48
103617,24,-6,30,52,2.35
103618,28,-5,33,65,2.2
103619,29,-5,34,54,2
103620,25,-6,31,78,2.59
103621,23,-7,30,139,3.86
103622,24,-8,32,78,2.51
103623,27,-7,34,44,1.84
103624,27,-7,34,53,1.73
103625,23,-9,32,78,2.79
103626,25,-7,32,61,2.04
103627,24,-7,31,67,2.3
103628,23,-7,30,68,2.21
103629,26,-6,32,72,2.49
103630,24,-7,31,97,3.09
103632,24,-6,30,65,2.09
103633,24,-6,30,52,2.47
103634,30,-3,33,31,2.62
103635,28,-5,33,47,2.48
103636,29,-4,33,42,2.25
103637,20,-5,25,133,3.26
103638,24,-4,28,161,3.42
103639,21,-5,26,126,3.37
103640,22,-2,24,228,6.21
103641,24,-5,29,70,2.61
103643,22,-5,27,197,4.36
103644,21,-4,25,316,6.47
103645,26,-2,28,95,5.45
103647,25,-4,29,94,3.82
103648,25,-3,28,277,5.12
103649,23,-3,26,289,5.72
103650,21,-5,26,198,3.99
103651,22,-3,25,275,5.09
103652,22,0,22,213,5.52
103653,25,0,25,146,7.23
103654,26,1,25,107,9.05
103655,21,-2,23,317,7.12
103656,25,0,25,183,7.02
103657,24,-1,25,234,7.27
103659,25,0,25,206,8.22
103660,26,0,26,122,8.44
103661,24,0,24,150,4.37
103662,23,-1,24,414,7.39
103663,25,-1,26,198,6.14
103664,27,1,26,123,3.98
103665,20,0,20,245,4.22
103666,21,1,20,251,4.07
103667,27,1,26,122,4.38
103668,23,-1,24,246,4.06
103669,19,1,18,312,4.24
103670,26,0,26,117,4.56
103671,23,-1,24,180,3.55
103672,22,-1,23,337,3.88
103673,23,1,22,333,4.4
103674,26,0,26,134,3.82
103675,24,0,24,402,4.92
103676,22,-1,23,427,4.65
103677,22,0,22,440,4.61
103678,24,-1,25,138,3.15
103679,21,1,20,255,4.06
103681,24,-13,37,99,4.05
103684,23,-14,37,106,3.99
103685,23,-14,37,103,4.23
103686,24,-14,38,102,4.22
103687,23,-14,37,103,4.05
103688,23,-14,37,104,4.37
103689,24,-15,39,100,4.22
103690,23,-14,37,103,4.12
103691,23,-14,37,101,4.07
103694,23,-14,37,100,4.07
103695,23,-15,38,100,4.12
103696,23,-14,37,95,3.91
103697,23,-15,38,100,3.92
103698,23,-14,37,98,3.88
103699,23,-15,38,96,3.75
103701,22,-15,37,100,4.35
103702,23,-15,38,99,4.23
103705,23,-15,38,97,3.79
103706,23,-15,38,98,3.94
103707,23,-14,37,97,3.88
103708,23,-14,37,98,3.74
103709,22,-15,37,97,3.63
103710,23,-15,38,95,4.01
103711,21,-14,35,97,4.03
103712,23,-15,38,101,4.3
103713,22,-14,36,108,5.34
103714,23,-15,38,101,4.28
103715,23,-15,38,102,4.56
103717,22,-15,37,106,5.27
103718,22,-15,37,102,4.23
103719,23,-15,38,100,4.14
103722,22,-15,37,100,4.41
103723,21,-14,35,103,4.97
103724,21,-15,36,104,5.1
103725,23,-15,38,97,4.46
103726,22,-15,37,96,4.9
103727,22,-15,37,98,4.1
103728,22,-15,37,94,4.37
103729,22,-15,37,97,4.29
103730,22,-15,37,98,4.66
103732,21,-14,35,102,4.76
103733,22,-15,37,95,4.23
103736,22,-15,37,95,4.14
103737,22,-15,37,94,3.87
103738,22,-16,38,94,3.87
103739,22,-15,37,96,4.03
103741,21,-15,36,102,6.01
103742,23,-11,34,84,7.37
103743,25,-10,35,79,7.67
103744,23,-11,34,82,7.18
103745,23,-11,34,81,7.02
103746,24,-11,35,82,7.95
103747,24,-9,33,78,4.95
103748,25,-12,37,84,7.9
103749,24,-13,37,78,7.78
103750,24,-10,34,81,8.25
103751,24,-14,38,78,7
103752,23,-14,37,78,6.58
103753,24,-14,38,77,5.78
103754,23,-13,36,95,6.36
103755,23,-15,38,80,7.13
103756,23,-14,37,83,7.7
103757,23,-14,37,85,7.91
103758,24,-15,39,86,7.97
103759,25,-14,39,79,7.28
103760,24,-13,37,86,6.63
103761,25,-15,40,82,8.05
103762,22,-15,37,77,8.2
103763,25,-15,40,78,8.74
103765,25,-16,41,77,9.67
103766,25,-16,41,79,8.32
103768,25,-16,41,75,8.32
103769,24,-17,41,73,7.42
103770,25,-16,41,71,8.16
103771,25,-16,41,71,7.37
103772,25,-16,41,71,6.96
103773,24,-17,41,67,6.09
103775,25,-17,42,68,6.83
103776,25,-17,42,64,7.83
103780,28,-11,39,36,2.8
103781,24,-11,35,69,3.98
103782,19,-11,30,103,3.71
103784,20,-14,34,90,3.29
103786,23,-11,34,56,2.6
103787,24,-11,35,46,1.95
103788,26,-11,37,34,2.03
103789,23,-12,35,55,2.31
103791,22,-12,34,68,3.02
103794,27,-10,37,35,2.34
103795,21,-13,34,78,2.39
103798,25,-10,35,54,2.26
103799,24,-11,35,76,3.05
103800,20,-11,31,79,2.15
103801,20,-11,31,101,2.5
103803,25,-11,36,47,1.99
103804,27,-11,38,47,2.93
103806,24,-10,34,113,3.4
103807,29,-8,37,80,2.19
103808,24,-8,32,117,2.48
103811,28,-9,37,32,2.75
103812,23,-10,33,110,3.31
103814,22,-10,32,122,3.49
103816,20,-9,29,164,3.1
103817,26,-10,36,66,2.76
103818,19,-10,29,125,3
103820,22,-10,32,100,2.44
103821,27,-7,34,92,3.04
103823,28,-6,34,73,2.92
103827,26,-7,33,101,3.01
103828,25,-7,32,129,3.42
103831,21,-9,30,158,2.81
103832,23,-8,31,139,3.17
103838,28,-8,36,117,3.08
103842,28,-7,35,87,3.11
103844,21,-8,29,169,3.46
103848,27,-5,32,53,1.93
103854,29,-6,35,65,2.92
103856,27,-7,34,83,3.28
103860,26,-8,34,88,3.09
103861,25,-6,31,75,1.92
103862,24,-6,30,80,2.59
103863,23,-6,29,75,2.35
103864,26,-5,31,110,3.88
103865,24,-6,30,103,2.7
103868,24,-6,30,71,2.67
103870,22,-6,28,83,2.56
103871,24,-5,29,100,2.09
103872,24,-6,30,82,2.14
103873,19,-5,24,252,3.57
103874,18,-8,26,126,3.08
103875,22,-7,29,89,2.32
103876,18,-6,24,169,3.06
103878,24,-3,27,203,3.35
103880,22,-7,29,113,2.53
103881,21,-4,25,219,2.95
103883,22,-6,28,140,2.5
103885,22,-3,25,310,4.69
103886,24,-2,26,406,5.6
103887,24,-1,25,179,6.04
103888,24,-1,25,170,4.17
103893,25,0,25,137,4.69
103894,25,-1,26,168,3.34
103895,24,-1,25,168,4.07
103896,25,0,25,127,4.25
103897,25,-1,26,193,4.54
103898,23,-1,24,212,4.25
103899,25,0,25,130,5.19
103900,25,0,25,109,4.55
103901,25,0,25,106,5.16
103902,25,0,25,123,6.31
103903,23,-1,24,153,4.92
103904,24,-1,25,191,3.57
103905,24,-1,25,397,4.22
103906,21,2,19,207,3.36
103907,23,0,23,242,3.85
103909,24,0,24,188,5.41
103910,22,1,21,288,3.93
103911,21,2,19,207,3.62
103912,25,-1,26,183,4.84
103913,22,0,22,296,5.07
103914,23,0,23,302,4.17
103915,25,0,25,140,4.19
103916,24,0,24,187,3.69
103917,22,1,21,232,3
103918,24,0,24,235,3.9
103919,19,2,17,184,3.44
103920,23,-15,38,96,4.06
103922,22,-14,36,97,3.79
103923,22,-15,37,95,4
103924,22,-15,37,95,3.73
103926,21,-15,36,95,4.23
103927,22,-15,37,92,3.66
103931,22,-15,37,97,4.2
103932,21,-14,35,97,3.83
103934,23,-17,40,75,6.4
103935,23,-16,39,78,5.99
103936,23,-18,41,73,5.6
103938,23,-17,40,73,5.77
103940,23,-17,40,76,5.67
103941,24,-18,42,71,5.34
103943,24,-17,41,73,6.97
103944,24,-17,41,72,6.64
103945,24,-17,41,72,6.58
103946,23,-18,41,72,6.29
103948,23,-18,41,71,7.16
103949,24,-18,42,67,6
103951,24,-18,42,71,6.64
103953,24,-17,41,74,6.56
103954,24,-17,41,70,6.33
103955,24,-18,42,68,6.05
103956,25,-17,42,69,6.33
103957,25,-17,42,67,7.18
103959,24,-17,41,67,6.27
103960,24,-17,41,64,6.95
103961,24,-17,41,66,6.12
103962,25,-17,42,62,8.32
103963,25,-17,42,66,7.18
103965,25,-17,42,61,7.41
103967,25,-17,42,65,6.2
103969,25,-18,43,60,6.61
103972,29,-10,39,34,3.11
103974,29,-11,40,34,2.68
103975,30,-12,42,35,2.44
103977,21,-13,34,111,2.74
103979,17,-13,30,98,2.99
103980,26,-11,37,59,2.26
103982,26,-10,36,53,2.78
103985,26,-8,34,74,3.1
103986,22,-10,32,91,3.29
103987,22,-10,32,132,3.06
103988,21,-9,30,77,2.93
103989,21,-10,31,116,2.66
103990,22,-8,30,79,2.29
103991,22,-8,30,96,2.98
103992,26,-8,34,47,2.06
103993,25,-8,33,47,2.03
103996,22,-9,31,123,2.64
103998,23,-8,31,126,3.35
104004,24,-8,32,117,3.24
104006,27,-6,33,91,3.54
104007,25,-8,33,96,2.84
104008,24,-8,32,76,2.17
104010,25,-8,33,126,3.59
104012,26,-8,34,109,3.11
104013,26,-7,33,77,3.42
104014,26,-7,33,105,2.88
104017,27,-6,33,82,3.08
104020,24,-8,32,141,3.56
104023,27,-6,33,80,3.4
104024,27,-6,33,66,3.69
104026,27,-6,33,62,3.18
104028,25,-7,32,119,3.47
104030,22,-8,30,140,3.69
104032,23,-8,31,118,4.74
104037,28,-6,34,46,2.94
104038,28,-6,34,43,4.83
104040,28,-6,34,55,3.8
104042,28,-7,35,51,2.97
104043,28,-7,35,50,2.46
104044,27,-6,33,43,1.79
104045,21,-8,29,184,3.78
104046,24,-7,31,81,2.87
104047,24,-6,30,80,2.71
104048,24,-6,30,99,2.66
104049,22,-7,29,156,3.05
104050,25,-7,32,86,2.95
104052,27,-7,34,74,2.88
104053,21,-8,29,103,2.3
104054,28,-7,35,30,2.23
104057,25,-7,32,126,1.93
104058,18,-6,24,170,2.89
104060,19,-7,26,257,3.6
104061,22,-3,25,169,4.72
104062,19,-4,23,202,4.97
104063,20,-5,25,242,4.19
104064,19,-5,24,280,5.71
104065,23,0,23,151,7.16
104066,20,-7,27,310,3.76
104067,18,-9,27,224,3.4
104068,22,-2,24,285,7.2
104069,23,0,23,179,6.7
104070,20,-8,28,220,3.02
104071,19,-2,21,376,7.28
104072,20,-5,25,329,5.01
104073,19,-2,21,365,7.01
104075,23,0,23,103,6.08
104076,24,1,23,119,7.71
104077,23,0,23,148,3.09
104078,24,1,23,98,2.36
104079,23,1,22,96,9.81
104080,22,1,21,92,7.8
104081,22,1,21,80,3.16
104082,22,0,22,297,5.28
104084,24,0,24,257,4.12
104085,22,0,22,271,3.47
104087,22,-1,23,477,3.6
104088,21,0,21,484,3.01
104089,23,1,22,297,2.78
104090,25,0,25,217,3.62
104091,23,-1,24,404,2.38
104092,20,0,20,382,2.42
104093,22,-1,23,219,1.44
104094,18,-3,21,153,2.79
104096,20,1,19,241,3.78
104097,18,1,17,237,3.12
104098,21,1,20,294,2.56
104099,19,1,18,285,1.84
104100,23,0,23,336,2.19
104101,21,1,20,289,2.55
104102,24,-18,42,69,6.38
104104,24,-19,43,67,5.79
104106,24,-19,43,57,5.83
104107,26,-17,43,51,6.93
104108,25,-18,43,55,6.8
104109,22,-10,32,63,3.41
104110,23,-11,34,134,3.52
104111,19,-12,31,135,2.82
104112,23,-10,33,87,3.84
104113,20,-11,31,108,3.77
104114,23,-13,36,64,2.49
104115,22,-11,33,111,2.42
104118,25,-10,35,60,2.99
104119,19,-12,31,159,4.01
104120,24,-12,36,60,2.47
104121,27,-7,34,74,2.87
104122,22,-12,34,96,2.66
104123,21,-9,30,121,2.85
104128,17,-10,27,204,4.39
104129,27,-6,33,65,2.28
104131,27,-6,33,77,3.5
104134,23,-9,32,107,3.82
104139,24,-8,32,89,3.12
104142,27,-7,34,66,2.59
104145,23,-9,32,95,2.72
104148,19,-10,29,185,3.82
104149,24,-10,34,82,2.66
104152,28,-6,34,59,3.22
104153,28,-6,34,57,3.21
104154,26,-8,34,66,2.77
104155,23,-8,31,59,2.41
104156,25,-9,34,99,2.97
104157,28,-6,34,59,2.68
104158,27,-7,34,70,2.98
104160,27,-7,34,56,2.19
104161,27,-7,34,78,2.53
104162,24,-9,33,88,2.4
104163,22,-11,33,106,2.72
104164,25,-8,33,105,2.38
104165,20,-11,31,131,2.62
104167,27,-7,34,70,2.1
104171,26,-8,34,61,2.76
104173,29,-7,36,43,2.04
104174,29,-7,36,31,2.1
104176,27,-9,36,40,2.27
104177,28,-9,37,36,1.84
104178,22,-9,31,69,2.15
104180,26,-9,35,61,1.93
104182,24,-11,35,42,1.59
104183,25,-11,36,46,1.58
104184,23,-9,32,69,2.28
104185,25,-11,36,43,1.57
104187,24,-11,35,42,2.01
104188,23,-8,31,88,1.99
104190,23,-10,33,51,1.46
104191,28,-8,36,34,1.71
104192,23,-10,33,49,2.37
104193,24,-11,35,46,2.01
104195,17,-12,29,78,2.27
104197,20,-12,32,75,1.9
104198,24,-11,35,49,1.83
104200,24,-8,32,49,1.55
104202,20,-9,29,121,2.33
104204,20,-10,30,119,2.29
104205,19,-10,29,68,2.01
104207,23,-10,33,70,1.95
104208,17,-10,27,134,2.34
104209,20,-9,29,171,2.32
104210,16,-11,27,94,2.06
104211,20,-4,24,319,4.2
104212,25,-1,26,190,5.89
104213,25,-7,32,242,3.84
104214,23,-1,24,245,6.62
104215,21,-6,27,306,3.59
104216,22,-3,25,402,5.61
104217,24,-2,26,242,5.03
104218,21,-4,25,224,2.86
104219,20,-6,26,335,3.41
104220,22,-2,24,264,2.95
104221,20,-4,24,374,4.58
104222,21,-4,25,229,4.13
104223,23,-1,24,175,5.54
104224,22,0,22,168,6.92
104225,23,-2,25,237,6.35
104226,22,0,22,186,1.95
104227,21,1,20,41,2.91
104229,23,1,22,281,2.81
104230,20,1,19,194,1.38
104231,20,1,19,237,1.83
104232,24,-19,43,58,5.75
104234,29,-1,30,114,16.06
104235,29,-1,30,113,14.82
104236,29,-2,31,114,15.36
104237,29,-1,30,114,15.69
104238,29,-1,30,113,16.43
104239,29,-1,30,114,15.6
104240,29,-2,31,114,15.78
104241,29,-2,31,113,16.43
104243,29,-2,31,114,15.78
104244,29,-2,31,114,16.44
104245,29,-2,31,115,15.15
104246,29,-2,31,113,14.17
104247,29,-2,31,115,14.12
104248,29,-2,31,114,14.04
104249,29,-2,31,113,14.64
104250,29,-2,31,113,14.68
104251,29,-2,31,113,15.24
104252,29,-2,31,112,14.84
104253,28,-3,31,119,17.72
104255,29,-1,30,114,15.69
104256,29,-1,30,113,15.46
104259,29,-1,30,114,15.6
104260,29,-1,30,114,15.59
104261,29,-2,31,113,15.22
104262,29,-2,31,114,16.44
104263,29,-1,30,115,15.59
104264,29,-2,31,116,15.15
104265,29,-2,31,114,8.97
104266,29,-2,31,113,14.59
104267,29,-2,31,113,14.28
104268,29,-2,31,113,15.24
104269,29,-2,31,111,14.84
104272,29,-1,30,114,15.36
104275,29,-2,31,114,15.89
104276,29,-2,31,114,15.78
104277,29,-2,31,113,15.22
104278,29,-2,31,115,15.59
104281,29,-2,31,114,14.04
104283,29,-2,31,113,14.68
104284,29,-2,31,114,14.65
104285,29,-2,31,110,14.84
104287,29,-2,31,113,15.73
104289,29,-2,31,114,15.89
104291,29,-2,31,113,14.68
104293,28,0,28,85,5.28
104294,22,-6,28,112,3.44
104295,22,-7,29,103,4.7
104297,26,-4,30,95,4.7
104298,27,0,27,87,4.56
104299,24,-3,27,97,4.7
104300,20,-8,28,112,3.44
104301,24,-3,27,97,4.7
104302,26,-2,28,96,4.7
104305,21,-9,30,114,3.36
104308,29,-7,36,31,1.65
104312,30,1,29,44,5.35
104313,27,-3,30,73,15.09
104315,30,-1,31,77,5.28
104318,23,-6,29,104,4.7
104319,31,1,30,56,11.12
104326,28,1,27,69,10.3
104327,28,1,27,66,10.3
104335,22,-16,38,64,3.32
104336,28,-1,29,93,17.24
104344,22,-3,25,103,3.91
104347,23,-5,28,101,4.7
104348,26,-3,29,72,11.48
104349,25,-5,30,67,8.29
104350,27,-1,28,96,17.48
104351,25,3,22,48,4.39
104352,28,-7,35,85,2.6
104353,33,2,31,69,7.61
104354,28,2,26,88,10.19
104355,31,1,30,121,7.65
104356,34,2,32,46,5.97
104357,32,1,31,86,8.92
104358,24,-2,26,88,4.56
104359,32,2,30,42,11.08
104360,27,1,26,96,12.19
104361,22,3,19,80,2.67
104362,28,1,27,79,10.3
104363,28,1,27,78,10.3
104366,27,-2,29,91,18.06
104370,16,-15,31,78,2.83
104371,25,-3,28,95,4.7
104372,27,2,25,84,4.56
104373,25,-5,30,79,11.52
104375,26,4,22,42,10.37
104377,29,1,28,70,10.3
104382,30,3,27,54,8.25
104383,23,5,18,42,15.98
104384,30,0,30,144,8
104389,25,-2,27,98,14.48
104392,30,1,29,79,5.28
104397,25,-6,31,65,6.78
104398,33,2,31,74,7.39
104399,31,0,31,104,5.28
104400,31,1,30,60,10.38
104401,25,-2,27,88,14.48
104402,29,2,27,30,4.73
104403,24,-7,31,96,2.15
104404,22,-7,29,110,3.78
104405,25,-6,31,105,3.74
104406,28,-6,34,41,1.6
104408,27,0,27,51,10.68
104409,27,0,27,49,9.18
104414,26,-2,28,71,7.72
104415,24,4,20,41,6.59
104418,33,4,29,60,7
104419,25,-2,27,92,4.7
104470,34,2,32,31,13.32
104471,27,-9,36,40,2.81
104472,27,-10,37,50,2.59
104473,20,-10,30,119,2.36
104474,23,-10,33,107,2.59
104475,24,-9,33,54,3.52
104476,33,2,31,33,13.76
104478,30,-4,34,116,2.86
104479,23,-6,29,103,4.86
104480,28,2,26,63,10.19
104482,33,3,30,57,9.93
104530,28,0,28,165,6.66
104531,21,4,17,44,5.11
104532,28,0,28,87,4.7
104533,29,0,29,82,5.28
104535,28,1,27,75,10.3
104536,34,0,34,38,4.89
104537,30,2,28,44,13.24
104538,32,1,31,100,7.47
104558,27,-3,30,92,4.96
104559,28,-7,35,57,2.72
104560,28,-2,30,87,4.7
104561,32,-3,35,98,3.38
104562,35,2,33,66,5.49
104563,35,2,33,99,6.12
104564,17,-15,32,80,2.83
104565,17,-15,32,80,2.83
104566,33,3,30,56,13.3
104567,34,1,33,74,7.33
104568,20,5,15,59,3.93
104570,23,3,20,76,9.3
104571,28,2,26,80,6.75
104572,28,3,25,48,5.78
104573,28,2,26,66,10.68
104574,28,2,26,68,10.68
104575,30,1,29,61,10.68
104579,26,-3,29,93,4.96
104580,26,-3,29,93,4.86
104581,26,-2,28,93,18.06
104582,23,-5,28,104,3.44
104583,33,1,32,85,7.21
104584,25,-8,33,57,3.06
104585,32,2,30,40,13.36
104586,26,-5,31,95,4.7
104587,25,-1,26,101,18.06
104595,23,-3,26,100,3.91
104597,26,-9,35,77,3.42
104598,23,-5,28,103,3.91
104599,27,3,24,56,7.26
104600,27,1,26,97,16.56
104602,34,2,32,27,12.06
104604,24,-5,29,98,3.91
104605,29,-2,31,99,4.01
104606,31,-3,34,98,3.28
104607,31,-4,35,47,1.62
104608,17.6,-2.64,20.24,302,0.75
104609,16.35,-11.63,27.98,59,0.75
104610,16.18,-6.65,22.83,243,0.75
104611,16.82,-10.76,27.58,58,0.75
104612,17.01,-4.54,21.55,419,0.75
104613,17.16,-3.27,20.43,246,0.75
104614,17.57,-2.13,19.7,232,0.75
104615,18.17,-1.39,19.56,179,0.75
104616,16.92,-12.32,29.24,58,0.75
104617,14.38,-7.42,21.8,150,0.75
104618,15.28,-3.25,18.53,378,0.75
104619,14.21,-8.15,22.36,433,0.75
104620,18.03,-0.92,18.95,174,0.75
104623,15.29,-2.58,17.87,348,0.75
104624,17.75,-0.85,18.6,379,0.75
104625,14.38,-6.24,20.62,285,0.75
104627,16.46,-2.99,19.45,318,0.75
104628,16.26,-5.12,21.38,388,0.75
104629,15.91,-4.7,20.61,398,0.75
104630,17.22,-0.53,17.75,282,0.75
104631,16.56,-4.87,21.43,245,0.75
104632,14.7,-4.98,19.68,418,0.75
104633,13.61,-7.68,21.29,408,0.75
104634,17.19,-3.2,20.39,247,0.75
104635,17.24,-13.26,30.5,43,0.75
104636,16.99,-2.66,19.65,264,0.75
104637,16.65,-2.76,19.41,144,0.75
104638,14.83,-5.71,20.54,360,0.75
104639,18.29,-3.61,21.9,353,0.75
104642,16.02,-4.58,20.6,212,0.46
104643,16.42,-4.25,20.67,228,1.4
104644,15.93,-5.11,21.04,215,1.26
104645,16.76,-4.22,20.98,171,0.9
104646,17.05,-3.74,20.79,175,0.61
104647,16.65,-4.56,21.21,211,0.54
104648,18.47,-5.85,24.32,91,0.87
104649,17.91,-6.59,24.5,93,0.87
104650,17.4,-1.79,19.19,404,0.73
104651,17.17,-2.68,19.85,464,0.64
104652,18.25,-0.6,18.85,335,1.02
104653,17.75,-1.29,19.04,373,0.87
104654,17.93,-1.61,19.54,345,0.34
104655,16.42,-1.61,18.03,287,2.18
104656,15.95,-2.35,18.3,304,0.64
104657,14.61,-4.36,18.97,374,0.76
104658,15.92,-2.56,18.48,344,0.5
104659,16.44,-1.79,18.23,286,0.75
104660,16.68,-1.43,18.11,257,0.9
104661,16.68,-1.43,18.11,257,0.75
104662,17.51,-2.02,19.53,258,0.87
104663,17.38,-1.71,19.09,274,0.52
104664,17.31,-2.25,19.56,291,0.54
104665,17.35,-11.44,28.79,66,1.05
104666,17.35,-11.44,28.79,66,1.15
104667,17.76,-11.68,29.44,65,0.84
104668,15.47,-8.34,23.81,179,0.99
104669,17.13,-11.58,28.71,66,0.81
104672,18.88,-14.2,33.08,34,0.73
104673,18,-13.09,31.09,39,0.71
104676,18.4,-12.77,31.17,34,1.6
104677,18.31,-12.82,31.13,42,0.96
104681,15.85,-4.16,20.01,392,0.87
104682,15.83,-6.5,22.33,204,1.52
104683,16.72,-11.87,28.59,51,1.02
104684,18.11,-11.76,29.87,47,0.93
104688,16.61,-11.53,28.14,62,0.61
104689,16.06,-7.13,23.19,72,1.48
104690,15.8,-5.75,21.55,95,1.19
104691,16.34,-2.96,19.3,190,0.54
104692,16.4,-2.7,19.1,194,0.84
104693,16.5,-5.43,21.93,195,1.48
104694,16.26,-2.55,18.81,192,2.14
104695,15.13,-4.38,19.51,209,0.71
104696,16.46,-3.96,20.42,195,1.22
104697,16.94,-2.65,19.59,175,1.52
104698,16.39,-2.56,18.95,178,1.72
104699,17.31,-3.9,21.21,229,0.96
104700,13.69,-10.08,23.77,150,1.6
104701,18.12,-0.8,18.92,342,0.32
104702,16.2,-1.96,18.16,291,0.68
104703,16.14,-2.09,18.23,302,0.71
104704,15.59,-3.44,19.03,357,0.66
104705,17.1,-8.24,25.34,151,1.12
104706,18.57,-13.24,31.81,38,0.37
104708,16.01,-3.57,19.58,372,0.68
104710,16.16,-3.76,19.92,198,0.59
104711,14.48,-3.61,18.09,325,0.75
104712,17.99,-2.13,20.12,227,0.75
104713,16.62,-3.11,19.73,419,0.75
104714,18.81,-2.62,21.43,252,0.75
104715,16.96,-2.5,19.46,274,0.75
104716,17.68,-13.45,31.13,50,0.75
104717,17.17,-3.53,20.7,175,0.75
104718,18.27,-14.57,32.84,38,0.75
104719,18.27,-14.57,32.84,38,0.75
104720,16.89,-3.14,20.03,360,0.75
104721,16.44,-3.73,20.17,414,0.75
104723,16.25,-0.97,17.22,234,0.75
104724,15.42,-2.48,17.9,264,0.75
104725,17.41,-3,20.41,279,0.75
104726,14.4,-6.87,21.27,377,0.75
104727,17.24,0.08,17.16,247,0.75
104728,14.43,-7.8,22.23,229,0.75
104729,17.97,-4.34,22.31,265,0.75
104730,15.39,-4.7,20.09,436,0.75
104732,17.18,-20.23,37.41,40,0.75
104733,14.53,-6.87,21.4,451,0.75
104734,18.27,-2.42,20.69,275,0.75
104735,16.34,-10.98,27.32,76,0.75
104736,17.27,-1.5,18.77,205,0.75
104737,16.02,-2.35,18.37,227,0.75
104738,18.21,-13.98,32.19,41,0.75
104739,17.75,-12.96,30.71,44,0.75
104740,19.36,-9.61,28.97,107,0.75
104741,18.43,-1,19.43,308,0.75
104742,16.28,-5.3,21.58,327,0.75
104743,16.88,-3.16,20.04,304,0.75
104744,16.73,-3.92,20.65,254,0.75
104746,15.97,-2.29,18.26,354,0.75
104747,17.67,-9.38,27.05,89,0.75
104748,17.76,0.09,17.67,234,0.75
104749,16.93,0.2,16.73,273,0.75
104750,16.51,-0.64,17.15,345,0.75
104751,14.18,-6.93,21.11,158,0.75
104752,16.41,-2.45,18.86,327,0.75
104753,17.45,-0.63,18.08,304,0.75
104754,15.25,-4.61,19.86,386,0.75
104755,15.76,-5.49,21.25,273,0.75
104756,18.3,-2.57,20.87,345,0.75
104757,17.8,-10.27,28.07,74,0.75
104758,16.27,-2.39,18.66,282,0.75
104759,13.7,-7.57,21.27,390,0.75
104760,14.64,-8,22.64,253,0.75
104761,17.46,-1.34,18.8,270,0.75
104762,13.71,-7.95,21.66,286,0.75
104763,17.94,-3.52,21.46,363,0.75
104764,15.33,-2.2,17.53,329,0.75
104765,16.08,-9.05,25.13,65,0.75
104766,16.01,-3.29,19.3,291,0.75
104767,16.44,-4.79,21.23,337,0.75
104768,17.15,-1.22,18.37,295,0.75
104769,17.83,-3.89,21.72,253,0.75
104770,18.21,-3.01,21.22,346,0.75
104771,17.18,-3.21,20.39,176,0.75
104772,17.46,-5.88,23.34,183,0.75
104773,16.79,-3.77,20.56,328,0.75
104774,15.48,-6.07,21.55,426,0.75
104775,18.01,-0.41,18.42,262,0.75
104776,15.69,-4.34,20.03,396,0.75
104777,14.73,-6.61,21.34,290,0.75
104778,16.05,-8.06,24.11,74,0.75
104780,15.82,-3.47,19.29,360,0.75
104781,15.87,-2.48,18.35,321,0.75
104782,17.74,-1.86,19.6,308,0.75
104783,18.11,-0.66,18.77,226,0.75
104784,15.26,-3.73,18.99,327,0.75
104785,17.41,-2.17,19.58,237,0.75
104786,15.42,-4.92,20.34,483,0.75
104787,17.78,-2.98,20.76,171,0.75
104788,18.32,-1.74,20.06,218,0.75
104789,16.77,-8.82,25.59,150,0.75
104790,15.42,-6.26,21.68,374,0.75
104791,16.95,-2.85,19.8,366,0.75
104792,17.16,-2.74,19.9,339,0.75
104793,16.86,-12.88,29.74,44,0.75
104794,17.38,-2.62,20,276,0.75
104795,18.1,-11.84,29.94,46,0.75
104796,25,-14,39,96,4.41
104797,24,-12,36,88,4
104798,25,-12,37,83,4
104799,20,-14,34,76,3.01
104800,17,-16,33,137,3.01
104801,22,-11,33,51,2.1
104802,21,-12,33,80,3.43
104803,22,-9,31,87,2.33
104804,24,-10,34,68,2.76
104805,24,-10,34,69,2.76
104806,23,-9,32,74,3.72
104807,23,-9,32,81,3.72
104808,25,-10,35,55,2.51
104809,19,-14,33,93,2.75
104810,22,-13,35,44,1.92
104811,21,-12,33,56,2.21
104812,23,-11,34,49,2.43
104813,24,-12,36,56,2.8
104814,25,-10,35,72,3.38
104815,19,-14,33,89,2.88
104816,21,-12,33,56,2.6
104817,25,-11,36,38,2.69
104818,22,-11,33,56,2.21
104819,22,-11,33,60,1.91
104820,26,-11,37,32,1.97
104821,23,-10,33,62,2.52
104822,24,-10,34,54,2.93
104823,24,-11,35,60,2.52
104824,20,-13,33,85,2.52
104830,25,-10,35,65,2.38
104831,20,-11,31,135,3.38
104832,23,-9,32,93,2.71
104833,23,-17,40,49,3.43
104834,23,-18,41,43,3.27
104835,24,-18,42,37,3.16
104836,24,-19,43,39,3.16
104837,24,-19,43,40,3.16
104838,20,-14,34,86,3.35
104839,20,-14,34,87,3.33
104841,20,-17,37,67,3.29
104842,24,-15,39,94,4.41
104843,24,-15,39,98,4.62
104844,23,-15,38,121,5.86
104845,21,-17,38,62,3.27
104847,23,-18,41,57,3.42
104848,22,-19,41,57,3.22
104849,22,-19,41,57,3.22
104850,23,-17,40,50,2.93
104851,22,-18,40,54,2.97
104852,21,-16,37,45,3.06
104853,17,-15,32,92,3.52
104854,19,-15,34,155,5.37
104855,19,-13,32,66,3.52
104856,20,-17,37,59,3.18
104857,20,-15,35,62,3.42
104860,19,-14,33,72,3.43
104861,21,-13,34,128,4.93
104862,21,-14,35,123,4.74
104863,27,-9,36,53,4.65
104865,25,-12,37,59,4.02
104866,26,-7,33,50,4.23
104867,27,-8,35,48,3.31
104869,19,-13,32,65,4.51
104870,27,-8,35,47,5.07
104871,19,-15,34,54,3.09
104872,17,-16,33,64,3.51
104874,19,-14,33,60,3.85
104875,24,-10,34,40,2.95
104879,21,-12,33,64,5.3
104880,21,-16,37,62,3.62
104881,21,-11,32,72,3.98
104882,27,-8,35,41,3.57
104883,27,-10,37,32,2.67
104884,27,-9,36,38,3.09
104885,23,-12,35,69,4.19
104889,28,-12,40,38,3.24
104890,23,-12,35,49,3.06
104893,29,-9,38,68,5.44
104900,27,-10,37,69,3.09
104901,22,-12,34,67,2.99
104902,21,-12,33,60,2.18
104904,23,-12,35,61,2.51
104905,27,-8,35,89,2.89
104906,22,-13,35,114,3.21
104907,21,-11,32,119,3.32
104908,22,-14,36,121,2
104909,21,-14,35,114,2.56
104910,26,-8,34,81,2.71
104911,26,-9,35,73,2.6
104912,22,-12,34,72,2.43
104913,22,-12,34,61,2.24
104914,24,-12,36,49,2.48
104915,22,-12,34,93,3.12
104916,25,-11,36,94,3.04
104917,27,-9,36,77,2.74
104918,30,-5,35,82,3.32
104919,24,-7,31,152,3.28
104920,29,-6,35,105,3.48
104921,23,-8,31,138,3.12
104922,28,-6,34,74,3.25
104923,26,-7,33,92,3.01
104924,25,-8,33,119,3.13
104925,25,-7,32,108,2.81
104926,23,-8,31,167,3.15
104927,26,-7,33,107,3.49
104928,23,-8,31,117,3.74
104929,25,-7,32,78,3.52
104930,25,-8,33,92,4.22
104931,26,-7,33,83,2.84
104932,20,-9,29,127,3.06
104933,27,-6,33,61,2.8
104934,24,-8,32,106,2.92
104941,27,-4,31,61,4.31
104943,29,-1,30,51,2.87
104944,30,0,30,51,3.48
104945,29,2,27,60,4.64
104946,28,-4,32,58,4.33
104951,23,-10,33,56,4.11
104952,21,-11,32,70,3.65
104953,22,-11,33,63,3.81
104954,21,-11,32,74,3.78
104955,28,-3,31,65,4.06
104956,30,-5,35,61,3.75
104958,26,-8,34,61,3.72
104959,29,-7,36,38,3.34
104960,25,-7,32,70,4.79
104961,28,-8,36,40,2.98
104962,28,-8,36,41,2.86
104963,32,-1,33,67,6.09
104964,29,-4,33,68,5.24
104965,28,-8,36,70,4.71
104966,28,-1,29,69,4.75
104967,27,-6,33,58,3.96
104968,31,-2,33,49,3.42
104969,32,-4,36,37,2.99
104974,27,-10,37,49,4.21
104975,29,-8,37,31,2.88
104977,29,-6,35,46,3.56
104979,27,-8,35,49,3.97
104980,29,-6,35,46,3.28
104982,28,-8,36,37,3.75
104983,29,-7,36,32,2.83
104986,27,-7,34,24,2.37
104987,25,-8,33,49,4.14
104988,30,-8,38,26,2.38
104989,28,-8,36,34,3.44
104991,24,-9,33,67,4.99
104996,29,-6,35,43,3.43
104999,30,-6,36,35,3.46
105003,29,-9,38,38,3.85
105004,22,-10,32,58,4.61
105005,18,-13,31,63,4.91
105007,21,-11,32,60,4.13
105008,18,-15,33,95,4.82
105009,20,-13,33,77,5.23
105010,25,-14,39,57,3.93
105011,23,-13,36,78,4.26
105012,20,-14,34,77,4.29
105013,18,-15,33,86,4.22
105014,22,-14,36,97,4.97
105015,29,-11,40,36,4.47
105016,28,-12,40,47,3.85
105017,25,-13,38,58,3.99
105018,23,-15,38,61,4.15
105019,20,-16,36,57,3.33
105020,22,-19,41,46,3.44
105021,24,-11,35,66,4.75
105022,25,-11,36,59,4.93
105025,20,-13,33,76,4.44
105026,24,-12,36,48,3.11
105029,29,-9,38,38,3.85
105031,24,-9,33,54,7.15
105032,22,-12,34,60,4.64
105033,19,-13,32,57,4.12
105034,24,-10,34,44,3.89
105035,21,-12,33,39,3.13
105036,21,-13,34,34,2.78
105037,19,-14,33,67,3.05
105038,20,-13,33,70,3.58
105039,22,-12,34,29,3.51
105040,22,-13,35,40,2.26
105041,21,-13,34,48,2.72
105042,26,-10,36,41,3.22
105043,18,-14,32,65,3.23
105044,29,-8,37,39,3.67
105045,25,-9,34,44,3.81
105046,28,-8,36,45,3.33
105048,28,-8,36,37,3.06
105053,18,-14,32,96,4.05
105060,19,-12,31,79,4.4
105063,19,-15,34,121,4.52
105064,19,-15,34,104,4.49
105065,23,-12,35,74,3.55
105067,29,-10,39,33,2.85
105068,26,-11,37,37,2.76
105071,17,-15,32,81,3.77
105073,28,-7,35,48,3.47
105074,27,-1,28,214,1.94
105075,20,-15,35,92,4.86
105080,21,-12,33,94,4.09
105083,27,-8,35,36,1.81
105084,27,-9,36,49,2.47
105086,21,-15,36,62,2.78
105087,24,-15,39,79,3.77
105088,19,-14,33,94,2.87
105089,23,-12,35,66,3.29
105090,25,-12,37,79,4.02
105091,25,-12,37,57,3.65
105092,25,-14,39,63,1.87
105093,22,-15,37,90,1.95
105094,29,-9,38,56,2.7
105095,23,-10,33,126,2.89
105096,26,-8,34,75,1.72
105097,27,1,26,172,2.87
105098,30,-12,42,38,2.82
105100,22,-11,33,61,3.62
105101,23,-15,38,47,3.5
105102,19,-15,34,106,3.25
105103,19,-16,35,116,3.98
105104,24,-14,38,70,3.64
105105,23,-15,38,94,3.65
105106,21,-12,33,65,1.73
105108,21,-13,34,81,1.99
105110,23,-12,35,87,1.96
105111,27,-12,39,63,2.25
105112,24,-8,32,88,3.23
105113,21,-11,32,66,2.88
105115,20,-13,33,124,2.4
105116,20,-12,32,108,2.35
105117,27,-12,39,68,2.59
105118,22,-14,36,93,2.48
105119,20,-15,35,129,2.63
105120,24,-10,34,99,2.73
105121,25,-9,34,104,2.55
105122,25,-1,26,248,7.99
105123,22,-12,34,51,2.56
105124,20,-13,33,67,2.44
105125,20,-12,32,84,2.57
105126,26,-10,36,99,3.13
105127,27,-8,35,109,3.44
105128,21,-9,30,168,3.81
105129,30,-14,44,34,3.56
105130,29,-11,40,36,2.53
105131,19,-13,32,91,2.67
105132,24,-10,34,65,2.45
105134,19,-12,31,152,2.68
105135,27,-9,36,44,2.04
105136,20,-9,29,127,2.72
105137,20,-9,29,120,2.33
105138,20,-9,29,141,2.46
105139,28,-6,34,82,3.12
105140,26,-7,33,80,4.02
105141,24,-11,35,64,2.45
105142,28,-6,34,71,3.08
105143,22,-11,33,89,2.57
105144,26,-7,33,68,2.37
105148,33,5,28,124,10.63
105151,28,-11,39,37,3.86
105152,29,-8,37,26,3.38
105153,22,-11,33,85,4.18
105155,24,-10,34,93,3.02
105156,23,-10,33,118,2.85
105157,26,-7,33,110,3.27
105160,22,-13,35,115,4.18
105166,24,-18,42,69,5.36
105174,32,2,30,141,9.49
105176,32,1,31,146,10.67
105177,31,0,31,147,13.4
105181,26,-4,30,119,10.8
105183,30,-3,33,109,12.79
105184,30,-3,33,115,11.5
105185,24,-16,40,71,6.87
105186,24,-18,42,67,5.52
105187,25,-17,42,62,6.52
105188,24,-17,41,71,6.92
105189,25,-17,42,69,7.27
105190,21,-17,38,84,5.89
105191,25,-16,41,69,8.62
105192,25,-17,42,66,6.84
105193,24,-18,42,71,6.32
105194,24,-17,41,67,6.09
105195,23,-17,40,75,6.42
105196,24,-19,43,58,5.9
105197,24,-18,42,72,6.23
105198,24,-18,42,71,5.18
105199,26,-16,42,67,9.49
105204,32,4,28,129,9.03
105205,30,-3,33,115,11.5
105246,18,-14,32,62,2.93
105248,26,-11,37,53,6.14
105270,25,-7,32,114,12.81
105272,25,-7,32,114,12.85
105273,24,-8,32,115,12.81
105274,24,-8,32,115,13.42
105275,23,-8,31,120,12.8
105276,24,-8,32,115,13.27
105288,28,-9,37,74,2.59
105346,24,-8,32,116,12.18
105357,25,-8,33,114,12.57
105365,25,-7,32,115,13.31
105368,25,-8,33,113,12.57
105373,25,-7,32,113,13.28
105376,25,-7,32,114,12.7
105381,26,-7,33,112,13.35
105385,25,-7,32,115,13.85
105390,24,-7,31,115,12.85
105395,24,-8,32,117,12.69
105397,24,-8,32,117,13.42
105404,25,-8,33,118,12.83
105407,24,-8,32,119,12.38
105417,24,-8,32,115,12.69
105421,24,-8,32,116,12.69
105422,24,-8,32,115,13.06
105429,25,-7,32,115,12.69
105432,24,-8,32,114,13.27
105441,25,-8,33,112,12.58
105452,28,-7,35,76,2.93
105477,21,-14,35,134,4.38
105516,16.64,-11.28,27.92,62,0.75
105526,16.06,-2.39,18.45,334,0.75
105545,26,-8,34,112,3.36
105592,14.16,-5.03,19.19,362,0.75
105613,18.18,-11.46,29.64,41,0.75
105619,16.6,-8.73,25.33,205,0.75
105622,16.51,-0.64,17.15,345,0.75
105633,15.41,-2.6,18.01,365,0.75
105634,15.39,-4.07,19.46,626,0.75
105688,16.93,-2.38,19.31,328,0.75
105698,14.6,-9.8,24.4,102,0.75
105699,17.52,-12.73,30.25,44,0.75
105703,20,-11,31,58,5.07
